Ref ID,Date,ppm,Rep,Plate,Row,Column,Count,Dead,Live
57H,5/25/21,8,1,1,A,1,16,15,1
57H,5/25/21,4,1,1,A,2,13,13,0
57H,5/25/21,2,1,1,A,3,17,15,2
57H,5/25/21,1,1,1,A,4,11,9,2
57H,5/25/21,0.5,1,1,A,5,11,11,0
57H,5/25/21,0.25,1,1,A,6,10,2,8
57H,5/25/21,0.125,1,1,A,7,23,2,21
57H,5/25/21,0.0625,1,1,A,8,12,1,11
57H,5/25/21,0.03125,1,1,A,9,19,2,17
57H,5/25/21,0.015625,1,1,A,10,16,2,14
VC,5/25/21,0,1,1,A,12,17,5,12
57B,5/25/21,4,1,1,B,1,14,14,0
57B,5/25/21,2,1,1,B,2,20,20,0
57B,5/25/21,1,1,1,B,3,11,11,0
57B,5/25/21,0.5,1,1,B,4,10,10,0
57B,5/25/21,0.25,1,1,B,5,10,7,3
57B,5/25/21,0.125,1,1,B,6,12,5,7
57B,5/25/21,0.0625,1,1,B,7,12,0,12
57B,5/25/21,0.03125,1,1,B,8,11,2,9
57B,5/25/21,0.015625,1,1,B,9,16,4,12
57B,5/25/21,0.0078125,1,1,B,10,24,2,22
VC,5/25/21,0,1,1,B,12,17,3,14
57D,5/25/21,4,1,1,C,1,14,13,1
57D,5/25/21,2,1,1,C,2,14,14,0
57D,5/25/21,1,1,1,C,3,14,14,0
57D,5/25/21,0.5,1,1,C,4,10,10,0
57D,5/25/21,0.25,1,1,C,5,12,11,1
57D,5/25/21,0.125,1,1,C,6,8,3,5
57D,5/25/21,0.0625,1,1,C,7,17,1,16
57D,5/25/21,0.03125,1,1,C,8,6,0,6
57D,5/25/21,0.015625,1,1,C,9,12,1,11
57D,5/25/21,0.0078125,1,1,C,10,10,1,9
VC,5/25/21,0,1,1,C,12,16,2,14
57F,5/25/21,4,1,1,D,1,13,13,0
57F,5/25/21,2,1,1,D,2,10,9,1
57F,5/25/21,1,1,1,D,3,16,15,1
57F,5/25/21,0.5,1,1,D,4,12,10,2
57F,5/25/21,0.25,1,1,D,5,15,8,7
57F,5/25/21,0.125,1,1,D,6,15,2,13
57F,5/25/21,0.0625,1,1,D,7,12,1,11
57F,5/25/21,0.03125,1,1,D,8,11,2,9
57F,5/25/21,0.015625,1,1,D,9,11,1,10
57F,5/25/21,0.0078125,1,1,D,10,23,2,21
VC,5/25/21,0,1,1,D,12,14,0,14
57A,5/25/21,16,1,1,E,1,18,18,0
57A,5/25/21,8,1,1,E,2,12,12,0
57A,5/25/21,4,1,1,E,3,11,10,1
57A,5/25/21,2,1,1,E,4,16,15,1
57A,5/25/21,1,1,1,E,5,13,12,1
57A,5/25/21,0.5,1,1,E,6,13,13,0
57A,5/25/21,0.25,1,1,E,7,15,10,5
57A,5/25/21,0.125,1,1,E,8,18,2,16
57A,5/25/21,0.0625,1,1,E,9,8,1,7
57A,5/25/21,0.03125,1,1,E,10,9,1,8
VC,5/25/21,0,1,1,E,12,12,3,9
57G,5/25/21,2,1,1,F,1,7,7,0
57G,5/25/21,1,1,1,F,2,8,7,1
57G,5/25/21,0.5,1,1,F,3,13,13,0
57G,5/25/21,0.25,1,1,F,4,12,9,3
57G,5/25/21,0.125,1,1,F,5,12,4,8
57G,5/25/21,0.0625,1,1,F,6,10,0,10
57G,5/25/21,0.03125,1,1,F,7,21,1,20
57G,5/25/21,0.015625,1,1,F,8,20,1,19
57G,5/25/21,0.0078125,1,1,F,9,14,2,12
57G,5/25/21,0.00390625,1,1,F,10,17,1,16
VC,5/25/21,0,1,1,F,12,14,0,14
57E,5/25/21,32,1,1,G,1,8,8,0
57E,5/25/21,16,1,1,G,2,10,9,1
57E,5/25/21,8,1,1,G,3,11,11,0
57E,5/25/21,4,1,1,G,4,12,10,2
57E,5/25/21,2,1,1,G,5,18,18,0
57E,5/25/21,1,1,1,G,6,15,13,2
57E,5/25/21,0.5,1,1,G,7,18,15,3
57E,5/25/21,0.25,1,1,G,8,9,4,5
57E,5/25/21,0.125,1,1,G,9,9,2,7
57E,5/25/21,0.0625,1,1,G,10,11,6,5
VC,5/25/21,0,1,1,G,12,20,4,16
57C,5/25/21,1,1,1,H,1,10,10,0
57C,5/25/21,0.5,1,1,H,2,14,11,3
57C,5/25/21,0.25,1,1,H,3,16,4,12
57C,5/25/21,0.125,1,1,H,4,9,2,7
57C,5/25/21,0.0625,1,1,H,5,19,6,13
57C,5/25/21,0.03125,1,1,H,6,17,4,13
57C,5/25/21,0.015625,1,1,H,7,14,1,13
57C,5/25/21,0.0078125,1,1,H,8,20,2,18
57C,5/25/21,0.00390625,1,1,H,9,14,2,12
57C,5/25/21,0.001953125,1,1,H,10,22,3,19
VC,5/25/21,0,1,1,H,12,11,2,9
57F,5/26/21,4,1,1,A,1,14,14,0
57F,5/26/21,2,1,1,A,2,9,9,0
57F,5/26/21,1,1,1,A,3,9,9,0
57F,5/26/21,0.5,1,1,A,4,4,4,0
57F,5/26/21,0.25,1,1,A,5,8,8,0
57F,5/26/21,0.125,1,1,A,6,2,2,0
57F,5/26/21,0.0625,1,1,A,7,7,1,6
57F,5/26/21,0.03125,1,1,A,8,6,0,6
57F,5/26/21,0.015625,1,1,A,9,7,0,7
57F,5/26/21,0.0078125,1,1,A,10,10,4,6
VC,5/26/21,0,1,1,A,12,9,1,8
57A,5/26/21,16,1,1,B,1,12,11,1
57A,5/26/21,8,1,1,B,2,6,6,0
57A,5/26/21,4,1,1,B,3,11,11,0
57A,5/26/21,2,1,1,B,4,9,9,0
57A,5/26/21,1,1,1,B,5,8,8,0
57A,5/26/21,0.5,1,1,B,6,6,6,0
57A,5/26/21,0.25,1,1,B,7,14,9,5
57A,5/26/21,0.125,1,1,B,8,8,0,8
57A,5/26/21,0.0625,1,1,B,9,12,1,11
57A,5/26/21,0.03125,1,1,B,10,7,2,5
VC,5/26/21,0,1,1,B,12,7,1,6
57D,5/26/21,8,1,1,C,1,9,9,0
57D,5/26/21,4,1,1,C,2,10,10,0
57D,5/26/21,2,1,1,C,3,8,8,0
57D,5/26/21,1,1,1,C,4,7,7,0
57D,5/26/21,0.5,1,1,C,5,4,3,1
57D,5/26/21,0.25,1,1,C,6,7,0,7
57D,5/26/21,0.125,1,1,C,7,11,0,11
57D,5/26/21,0.0625,1,1,C,8,7,0,7
57D,5/26/21,0.03125,1,1,C,9,9,1,8
57D,5/26/21,0.015625,1,1,C,10,12,1,11
VC,5/26/21,0,1,1,C,12,5,0,5
57E,5/26/21,32,1,1,D,1,6,6,0
57E,5/26/21,16,1,1,D,2,7,7,0
57E,5/26/21,8,1,1,D,3,6,6,0
57E,5/26/21,4,1,1,D,4,15,13,2
57E,5/26/21,2,1,1,D,5,7,7,0
57E,5/26/21,1,1,1,D,6,5,5,0
57E,5/26/21,0.5,1,1,D,7,8,8,0
57E,5/26/21,0.25,1,1,D,8,5,1,4
57E,5/26/21,0.125,1,1,D,9,5,2,3
57E,5/26/21,0.0625,1,1,D,10,5,0,5
VC,5/26/21,0,1,1,D,12,7,0,7
57H,5/26/21,4,1,1,E,1,12,12,0
57H,5/26/21,2,1,1,E,2,10,10,0
57H,5/26/21,1,1,1,E,3,11,11,0
57H,5/26/21,0.5,1,1,E,4,12,12,0
57H,5/26/21,0.25,1,1,E,5,11,11,0
57H,5/26/21,0.125,1,1,E,6,1,0,1
57H,5/26/21,0.0625,1,1,E,7,9,0,9
57H,5/26/21,0.03125,1,1,E,8,11,0,11
57H,5/26/21,0.015625,1,1,E,9,9,0,9
57H,5/26/21,0.0078125,1,1,E,10,12,0,12
VC,5/26/21,0,1,1,E,12,6,0,6
57C,5/26/21,1,1,1,F,1,9,9,0
57C,5/26/21,0.5,1,1,F,2,8,8,0
57C,5/26/21,0.25,1,1,F,3,7,5,2
57C,5/26/21,0.125,1,1,F,4,4,2,2
57C,5/26/21,0.0625,1,1,F,5,6,1,5
57C,5/26/21,0.03125,1,1,F,6,10,0,10
57C,5/26/21,0.015625,1,1,F,7,5,0,5
57C,5/26/21,0.0078125,1,1,F,8,8,0,8
57C,5/26/21,0.00390625,1,1,F,9,12,2,10
57C,5/26/21,0.001953125,1,1,F,10,12,1,11
VC,5/26/21,0,1,1,F,12,3,0,3
57B,5/26/21,4,1,1,G,1,9,8,1
57B,5/26/21,2,1,1,G,2,12,12,0
57B,5/26/21,1,1,1,G,3,12,12,0
57B,5/26/21,0.5,1,1,G,4,11,10,1
57B,5/26/21,0.25,1,1,G,5,12,9,3
57B,5/26/21,0.125,1,1,G,6,5,3,2
57B,5/26/21,0.0625,1,1,G,7,4,2,2
57B,5/26/21,0.03125,1,1,G,8,7,0,7
57B,5/26/21,0.015625,1,1,G,9,8,1,7
57B,5/26/21,0.0078125,1,1,G,10,12,2,10
VC,5/26/21,0,1,1,G,12,9,2,7
57G,5/26/21,2,1,1,H,1,7,7,0
57G,5/26/21,1,1,1,H,2,9,9,0
57G,5/26/21,0.5,1,1,H,3,3,3,0
57G,5/26/21,0.25,1,1,H,4,3,3,0
57G,5/26/21,0.125,1,1,H,5,3,0,3
57G,5/26/21,0.0625,1,1,H,6,1,0,1
57G,5/26/21,0.03125,1,1,H,7,4,1,3
57G,5/26/21,0.015625,1,1,H,8,16,2,14
57G,5/26/21,0.0078125,1,1,H,9,7,0,7
57G,5/26/21,0.00390625,1,1,H,10,4,2,2
VC,5/26/21,0,1,1,H,12,5,0,5
59A,5/28/21,8,1,1,A,1,10,10,0
59A,5/28/21,4,1,1,A,2,11,11,0
59A,5/28/21,2,1,1,A,3,10,10,0
59A,5/28/21,1,1,1,A,4,7,7,0
59A,5/28/21,0.5,1,1,A,5,12,12,0
59A,5/28/21,0.25,1,1,A,6,10,9,1
59A,5/28/21,0.125,1,1,A,7,8,7,1
59A,5/28/21,0.0625,1,1,A,8,16,13,3
59A,5/28/21,0.03125,1,1,A,9,10,5,5
59A,5/28/21,0.015625,1,1,A,10,14,2,12
VC,5/28/21,0,1,1,A,12,14,5,9
59C,5/28/21,8,1,1,B,1,16,11,5
59C,5/28/21,4,1,1,B,2,6,4,2
59C,5/28/21,2,1,1,B,3,7,3,4
59C,5/28/21,1,1,1,B,4,4,1,3
59C,5/28/21,0.5,1,1,B,5,14,4,10
59C,5/28/21,0.25,1,1,B,6,11,0,11
59C,5/28/21,0.125,1,1,B,7,8,2,6
59C,5/28/21,0.0625,1,1,B,8,14,0,14
59C,5/28/21,0.03125,1,1,B,9,11,2,9
59C,5/28/21,0.015625,1,1,B,10,6,0,6
VC,5/28/21,0,1,1,B,12,9,0,9
59F,5/28/21,8,1,1,C,1,10,4,6
59F,5/28/21,4,1,1,C,2,8,1,7
59F,5/28/21,2,1,1,C,3,8,1,7
59F,5/28/21,1,1,1,C,4,8,2,6
59F,5/28/21,0.5,1,1,C,5,5,0,5
59F,5/28/21,0.25,1,1,C,6,10,0,10
59F,5/28/21,0.125,1,1,C,7,13,4,9
59F,5/28/21,0.0625,1,1,C,8,9,0,9
59F,5/28/21,0.03125,1,1,C,9,13,0,13
59F,5/28/21,0.015625,1,1,C,10,8,1,7
VC,5/28/21,0,1,1,C,12,10,2,8
59G,5/28/21,16,1,1,D,1,10,4,6
59G,5/28/21,8,1,1,D,2,8,3,5
59G,5/28/21,4,1,1,D,3,12,5,7
59G,5/28/21,2,1,1,D,4,9,2,7
59G,5/28/21,1,1,1,D,5,12,3,9
59G,5/28/21,0.5,1,1,D,6,11,0,11
59G,5/28/21,0.25,1,1,D,7,11,0,11
59G,5/28/21,0.125,1,1,D,8,8,0,8
59G,5/28/21,0.0625,1,1,D,9,10,0,10
59G,5/28/21,0.03125,1,1,D,10,10,2,8
VC,5/28/21,0,1,1,D,12,8,1,7
38A,5/28/21,16,1,1,E,1,9,9,0
38A,5/28/21,8,1,1,E,2,8,8,0
38A,5/28/21,4,1,1,E,3,20,16,4
38A,5/28/21,2,1,1,E,4,14,7,7
38A,5/28/21,1,1,1,E,5,13,3,10
38A,5/28/21,0.5,1,1,E,6,9,1,8
38A,5/28/21,0.25,1,1,E,7,12,3,9
38A,5/28/21,0.125,1,1,E,8,8,0,8
38A,5/28/21,0.0625,1,1,E,9,6,0,6
38A,5/28/21,0.03125,1,1,E,10,8,1,7
VC,5/28/21,0,1,1,E,12,11,1,10
38F,5/28/21,8,1,1,F,1,10,10,0
38F,5/28/21,4,1,1,F,2,8,8,0
38F,5/28/21,2,1,1,F,3,23,19,4
38F,5/28/21,1,1,1,F,4,17,8,9
38F,5/28/21,0.5,1,1,F,5,15,7,8
38F,5/28/21,0.25,1,1,F,6,10,2,8
38F,5/28/21,0.125,1,1,F,7,12,2,10
38F,5/28/21,0.0625,1,1,F,8,9,1,8
38F,5/28/21,0.03125,1,1,F,9,6,1,5
38F,5/28/21,0.015625,1,1,F,10,8,1,7
VC,5/28/21,0,1,1,F,12,15,0,15
35H,5/28/21,1.28,1,1,G,1,8,8,0
35H,5/28/21,0.64,1,1,G,2,10,5,5
35H,5/28/21,0.32,1,1,G,3,11,2,9
35H,5/28/21,0.16,1,1,G,4,5,0,5
35H,5/28/21,0.08,1,1,G,5,8,0,8
35H,5/28/21,0.04,1,1,G,6,14,2,12
35H,5/28/21,0.02,1,1,G,7,13,2,11
35H,5/28/21,0.01,1,1,G,8,4,0,4
35H,5/28/21,0.005,1,1,G,9,12,1,11
35H,5/28/21,0.0025,1,1,G,10,9,1,8
VC,5/28/21,0,1,1,G,12,7,0,7
1036-14B,5/28/21,1.28,1,1,H,1,11,11,0
1036-14B,5/28/21,0.64,1,1,H,2,13,12,1
1036-14B,5/28/21,0.32,1,1,H,3,17,17,0
1036-14B,5/28/21,0.16,1,1,H,4,10,4,6
1036-14B,5/28/21,0.08,1,1,H,5,16,5,11
1036-14B,5/28/21,0.04,1,1,H,6,9,3,6
1036-14B,5/28/21,0.02,1,1,H,7,6,0,6
1036-14B,5/28/21,0.01,1,1,H,8,14,0,14
1036-14B,5/28/21,0.005,1,1,H,9,9,0,9
1036-14B,5/28/21,0.0025,1,1,H,10,9,1,8
VC,5/28/21,0,1,1,H,12,6,2,4
35L,6/9/21,1.28,1,1,E,1,10,5,5
35L,6/9/21,0.64,1,1,E,2,10,1,9
35L,6/9/21,0.32,1,1,E,3,14,2,12
35L,6/9/21,0.16,1,1,E,4,4,1,3
35L,6/9/21,0.08,1,1,E,5,9,1,8
35L,6/9/21,0.04,1,1,E,6,11,2,9
35L,6/9/21,0.02,1,1,E,7,9,2,7
35L,6/9/21,0.01,1,1,E,8,13,1,12
35L,6/9/21,0.005,1,1,E,9,11,1,10
35L,6/9/21,0.0025,1,1,E,10,6,0,6
VC,6/9/21,0,1,1,E,12,11,2,9
93B,6/9/21,139,1,1,F,1,8,2,6
93B,6/9/21,69.5,1,1,F,2,9,3,6
93B,6/9/21,34.75,1,1,F,3,11,2,9
93B,6/9/21,17.375,1,1,F,4,9,2,7
93B,6/9/21,8.6875,1,1,F,5,10,1,9
93B,6/9/21,4.34375,1,1,F,6,9,0,9
93B,6/9/21,2.171875,1,1,F,7,10,2,8
93B,6/9/21,1.0859375,1,1,F,8,10,1,9
93B,6/9/21,0.54296875,1,1,F,9,12,2,10
93B,6/9/21,0.271484375,1,1,F,10,9,2,7
VC,6/9/21,0,1,1,F,12,11,0,11
93C,6/9/21,130.5,1,1,G,1,13,3,10
93C,6/9/21,65.25,1,1,G,2,7,3,4
93C,6/9/21,32.625,1,1,G,3,12,2,10
93C,6/9/21,16.3125,1,1,G,4,6,1,5
93C,6/9/21,8.15625,1,1,G,5,9,4,5
93C,6/9/21,4.078125,1,1,G,6,9,3,6
93C,6/9/21,2.0390625,1,1,G,7,10,0,10
93C,6/9/21,1.01953125,1,1,G,8,4,1,3
93C,6/9/21,0.509765625,1,1,G,9,6,0,6
93C,6/9/21,0.254882813,1,1,G,10,11,3,8
VC,6/9/21,0,1,1,G,12,10,1,9
93A,6/9/21,16,1,1,H,1,8,8,0
93A,6/9/21,8,1,1,H,2,12,11,1
93A,6/9/21,4,1,1,H,3,12,12,0
93A,6/9/21,2,1,1,H,4,6,6,0
93A,6/9/21,1,1,1,H,5,4,4,0
93A,6/9/21,0.5,1,1,H,6,7,7,0
93A,6/9/21,0.25,1,1,H,7,12,10,2
93A,6/9/21,0.125,1,1,H,8,11,6,5
93A,6/9/21,0.0625,1,1,H,9,10,2,8
93A,6/9/21,0.03125,1,1,H,10,6,2,4
VC,6/9/21,0,1,1,H,12,7,2,5
58H,6/10/21,1,1,1,A,1,8,8,0
58H,6/10/21,0.5,1,1,A,2,8,4,4
58H,6/10/21,0.25,1,1,A,3,11,1,10
58H,6/10/21,0.125,1,1,A,4,11,2,9
58H,6/10/21,0.0625,1,1,A,5,10,2,8
58H,6/10/21,0.03125,1,1,A,6,10,1,9
58H,6/10/21,0.015625,1,1,A,7,10,3,7
58H,6/10/21,0.0078125,1,1,A,8,12,3,9
58H,6/10/21,0.00390625,1,1,A,9,9,3,6
58H,6/10/21,0.001953125,1,1,A,10,11,1,10
VC,6/10/21,0,1,1,A,12,9,2,7
58F,6/10/21,16,1,1,B,1,9,9,0
58F,6/10/21,8,1,1,B,2,13,13,0
58F,6/10/21,4,1,1,B,3,12,11,1
58F,6/10/21,2,1,1,B,4,8,6,2
58F,6/10/21,1,1,1,B,5,11,8,3
58F,6/10/21,0.5,1,1,B,6,11,5,6
58F,6/10/21,0.25,1,1,B,7,9,4,5
58F,6/10/21,0.125,1,1,B,8,12,0,12
58F,6/10/21,0.0625,1,1,B,9,11,2,9
58F,6/10/21,0.03125,1,1,B,10,3,3,0
VC,6/10/21,0,1,1,B,12,13,4,9
58A,6/10/21,4,1,1,C,1,12,11,1
58A,6/10/21,2,1,1,C,2,12,11,1
58A,6/10/21,1,1,1,C,3,10,8,2
58A,6/10/21,0.5,1,1,C,4,10,3,7
58A,6/10/21,0.25,1,1,C,5,11,2,9
58A,6/10/21,0.125,1,1,C,6,11,1,10
58A,6/10/21,0.0625,1,1,C,7,11,2,9
58A,6/10/21,0.03125,1,1,C,8,9,3,6
58A,6/10/21,0.015625,1,1,C,9,11,0,11
58A,6/10/21,0.0078125,1,1,C,10,9,0,9
VC,6/10/21,0,1,1,C,12,11,2,9
58C,6/10/21,4,1,1,D,1,11,11,0
58C,6/10/21,2,1,1,D,2,12,12,0
58C,6/10/21,1,1,1,D,3,12,11,1
58C,6/10/21,0.5,1,1,D,4,16,11,5
58C,6/10/21,0.25,1,1,D,5,11,3,8
58C,6/10/21,0.125,1,1,D,6,13,1,12
58C,6/10/21,0.0625,1,1,D,7,0,0,0
58C,6/10/21,0.03125,1,1,D,8,8,4,4
58C,6/10/21,0.015625,1,1,D,9,4,2,2
58C,6/10/21,0.0078125,1,1,D,10,2,1,1
VC,6/10/21,0,1,1,D,12,8,4,4
58G,6/10/21,32,1,1,E,1,13,13,0
58G,6/10/21,16,1,1,E,2,7,7,0
58G,6/10/21,8,1,1,E,3,12,12,0
58G,6/10/21,4,1,1,E,4,13,13,0
58G,6/10/21,2,1,1,E,5,9,9,0
58G,6/10/21,1,1,1,E,6,11,11,0
58G,6/10/21,0.5,1,1,E,7,9,3,6
58G,6/10/21,0.25,1,1,E,8,9,1,8
58G,6/10/21,0.125,1,1,E,9,9,1,8
58G,6/10/21,0.0625,1,1,E,10,10,0,10
VC,6/10/21,0,1,1,E,12,11,2,9
1036-14B,6/10/21,1.28,1,1,F,1,4,4,0
1036-14B,6/10/21,0.64,1,1,F,2,16,11,5
1036-14B,6/10/21,0.32,1,1,F,3,13,4,9
1036-14B,6/10/21,0.16,1,1,F,4,8,3,5
1036-14B,6/10/21,0.08,1,1,F,5,8,3,5
1036-14B,6/10/21,0.04,1,1,F,6,8,1,7
1036-14B,6/10/21,0.02,1,1,F,7,11,4,7
1036-14B,6/10/21,0.01,1,1,F,8,10,4,6
1036-14B,6/10/21,0.005,1,1,F,9,9,1,8
1036-14B,6/10/21,0.0025,1,1,F,10,14,10,4
VC,6/10/21,0,1,1,F,12,10,2,8
93E,6/11/21,140,1,1,A,1,10,1,9
93E,6/11/21,70,1,1,A,2,9,1,8
93E,6/11/21,35,1,1,A,3,9,1,8
93E,6/11/21,17.5,1,1,A,4,11,1,10
93E,6/11/21,8.75,1,1,A,5,10,0,10
93E,6/11/21,4.375,1,1,A,6,8,2,6
93E,6/11/21,2.1875,1,1,A,7,9,1,8
93E,6/11/21,1.09375,1,1,A,8,9,0,9
93E,6/11/21,0.546875,1,1,A,9,8,0,8
93E,6/11/21,0.2734375,1,1,A,10,10,0,10
VC,6/11/21,0,1,1,A,12,11,0,11
93B,6/11/21,139,1,1,B,1,10,0,10
93B,6/11/21,69.5,1,1,B,2,12,1,11
93B,6/11/21,34.75,1,1,B,3,11,0,11
93B,6/11/21,17.375,1,1,B,4,11,1,10
93B,6/11/21,8.6875,1,1,B,5,12,0,12
93B,6/11/21,4.34375,1,1,B,6,11,2,9
93B,6/11/21,2.171875,1,1,B,7,13,3,10
93B,6/11/21,1.0859375,1,1,B,8,10,0,10
93B,6/11/21,0.54296875,1,1,B,9,10,0,10
93B,6/11/21,0.271484375,1,1,B,10,10,0,10
VC,6/11/21,0,1,1,B,12,11,0,11
59E,6/11/21,8,1,1,C,1,11,10,1
59E,6/11/21,4,1,1,C,2,12,12,0
59E,6/11/21,2,1,1,C,3,13,12,1
59E,6/11/21,1,1,1,C,4,12,12,0
59E,6/11/21,0.5,1,1,C,5,13,12,1
59E,6/11/21,0.25,1,1,C,6,10,8,2
59E,6/11/21,0.125,1,1,C,7,14,4,10
59E,6/11/21,0.0625,1,1,C,8,9,1,8
59E,6/11/21,0.03125,1,1,C,9,11,1,10
59E,6/11/21,0.015625,1,1,C,10,13,0,13
VC,6/11/21,0,1,1,C,12,11,3,8
59B,6/11/21,8,1,1,D,1,11,11,0
59B,6/11/21,4,1,1,D,2,12,12,0
59B,6/11/21,2,1,1,D,3,10,10,0
59B,6/11/21,1,1,1,D,4,15,3,12
59B,6/11/21,0.5,1,1,D,5,11,1,10
59B,6/11/21,0.25,1,1,D,6,10,0,10
59B,6/11/21,0.125,1,1,D,7,19,0,19
59B,6/11/21,0.0625,1,1,D,8,10,1,9
59B,6/11/21,0.03125,1,1,D,9,11,1,10
59B,6/11/21,0.015625,1,1,D,10,12,0,12
VC,6/11/21,0,1,1,D,12,10,1,9
1036-14B,6/11/21,1.28,1,1,E,1,16,16,0
1036-14B,6/11/21,0.64,1,1,E,2,25,21,4
1036-14B,6/11/21,0.32,1,1,E,3,16,2,14
1036-14B,6/11/21,0.16,1,1,E,4,15,2,13
1036-14B,6/11/21,0.08,1,1,E,5,17,1,16
1036-14B,6/11/21,0.04,1,1,E,6,4,0,4
1036-14B,6/11/21,0.02,1,1,E,7,14,2,12
1036-14B,6/11/21,0.01,1,1,E,8,16,0,16
1036-14B,6/11/21,0.005,1,1,E,9,18,2,16
1036-14B,6/11/21,0.0025,1,1,E,10,13,0,13
VC,6/11/21,0,1,1,E,12,15,1,14
93D,6/11/21,135,1,1,F,1,14,2,12
93D,6/11/21,67.5,1,1,F,2,21,3,18
93D,6/11/21,33.75,1,1,F,3,17,1,16
93D,6/11/21,16.875,1,1,F,4,14,2,12
93D,6/11/21,8.4375,1,1,F,5,1,,1
93D,6/11/21,4.21875,1,1,F,6,13,0,13
93D,6/11/21,2.109375,1,1,F,7,21,1,20
93D,6/11/21,1.0546875,1,1,F,8,13,1,12
93D,6/11/21,0.52734375,1,1,F,9,12,1,11
93D,6/11/21,0.263671875,1,1,F,10,13,2,11
VC,6/11/21,0,1,1,F,12,15,0,15
93A,6/11/21,16,1,1,G,1,15,15,0
93A,6/11/21,8,1,1,G,2,11,11,0
93A,6/11/21,4,1,1,G,3,12,12,0
93A,6/11/21,2,1,1,G,4,11,11,0
93A,6/11/21,1,1,1,G,5,14,14,0
93A,6/11/21,0.5,1,1,G,6,10,10,0
93A,6/11/21,0.25,1,1,G,7,13,11,2
93A,6/11/21,0.125,1,1,G,8,10,9,1
93A,6/11/21,0.0625,1,1,G,9,11,6,5
93A,6/11/21,0.03125,1,1,G,10,13,2,11
VC,6/11/21,0,1,1,G,12,14,0,14
93C,6/11/21,130.5,1,1,H,1,20,8,12
93C,6/11/21,65.25,1,1,H,2,11,3,8
93C,6/11/21,32.625,1,1,H,3,11,1,10
93C,6/11/21,16.3125,1,1,H,4,15,3,12
93C,6/11/21,8.15625,1,1,H,5,8,1,7
93C,6/11/21,4.078125,1,1,H,6,8,0,8
93C,6/11/21,2.0390625,1,1,H,7,10,0,10
93C,6/11/21,1.01953125,1,1,H,8,17,2,15
93C,6/11/21,0.509765625,1,1,H,9,11,1,10
93C,6/11/21,0.254882813,1,1,H,10,15,2,13
VC,6/11/21,0,1,1,H,12,9,1,8
93B,6/16/21,139,1,1,A,1,8,1,7
93B,6/16/21,69.5,1,1,A,2,13,2,11
93B,6/16/21,34.75,1,1,A,3,9,2,7
93B,6/16/21,17.375,1,1,A,4,9,1,8
93B,6/16/21,8.6875,1,1,A,5,8,2,6
93B,6/16/21,4.34375,1,1,A,6,7,2,5
93B,6/16/21,2.171875,1,1,A,7,6,2,4
93B,6/16/21,1.0859375,1,1,A,8,10,3,7
93B,6/16/21,0.54296875,1,1,A,9,8,0,8
93B,6/16/21,0.271484375,1,1,A,10,10,2,8
VC,6/16/21,0,1,1,A,12,11,0,11
59E,6/16/21,8,1,1,B,1,8,2,6
59E,6/16/21,4,1,1,B,2,8,4,4
59E,6/16/21,2,1,1,B,3,9,3,6
59E,6/16/21,1,1,1,B,4,9,3,6
59E,6/16/21,0.5,1,1,B,5,8,4,4
59E,6/16/21,0.25,1,1,B,6,13,8,5
59E,6/16/21,0.125,1,1,B,7,10,7,3
59E,6/16/21,0.0625,1,1,B,8,9,2,7
59E,6/16/21,0.03125,1,1,B,9,7,2,5
59E,6/16/21,0.015625,1,1,B,10,7,2,5
VC,6/16/21,0,1,1,B,12,9,0,9
93E,6/16/21,140,1,1,C,1,10,2,8
93E,6/16/21,70,1,1,C,2,8,1,7
93E,6/16/21,35,1,1,C,3,9,3,6
93E,6/16/21,17.5,1,1,C,4,9,1,8
93E,6/16/21,8.75,1,1,C,5,11,3,8
93E,6/16/21,4.375,1,1,C,6,9,3,6
93E,6/16/21,2.1875,1,1,C,7,10,1,9
93E,6/16/21,1.09375,1,1,C,8,8,3,5
93E,6/16/21,0.546875,1,1,C,9,10,2,8
93E,6/16/21,0.2734375,1,1,C,10,7,2,5
VC,6/16/21,0,1,1,C,12,10,1,9
93D,6/16/21,135,1,1,D,1,11,1,10
93D,6/16/21,67.5,1,1,D,2,10,1,9
93D,6/16/21,33.75,1,1,D,3,8,1,7
93D,6/16/21,16.875,1,1,D,4,11,1,10
93D,6/16/21,8.4375,1,1,D,5,9,1,8
93D,6/16/21,4.21875,1,1,D,6,11,3,8
93D,6/16/21,2.109375,1,1,D,7,10,0,10
93D,6/16/21,1.0546875,1,1,D,8,13,2,11
93D,6/16/21,0.52734375,1,1,D,9,10,1,9
93D,6/16/21,0.263671875,1,1,D,10,3,1,2
VC,6/16/21,0,1,1,D,12,10,0,10
93C,6/16/21,130.5,1,1,E,1,10,2,8
93C,6/16/21,65.25,1,1,E,2,13,1,12
93C,6/16/21,32.625,1,1,E,3,8,0,8
93C,6/16/21,16.3125,1,1,E,4,10,2,8
93C,6/16/21,8.15625,1,1,E,5,8,0,8
93C,6/16/21,4.078125,1,1,E,6,8,3,5
93C,6/16/21,2.0390625,1,1,E,7,9,3,6
93C,6/16/21,1.01953125,1,1,E,8,12,2,10
93C,6/16/21,0.509765625,1,1,E,9,8,2,6
93C,6/16/21,0.254882813,1,1,E,10,10,2,8
VC,6/16/21,0,1,1,E,12,7,0,7
59B,6/16/21,8,1,1,F,1,8,8,0
59B,6/16/21,4,1,1,F,2,8,8,0
59B,6/16/21,2,1,1,F,3,8,8,0
59B,6/16/21,1,1,1,F,4,9,4,5
59B,6/16/21,0.5,1,1,F,5,12,4,8
59B,6/16/21,0.25,1,1,F,6,13,1,12
59B,6/16/21,0.125,1,1,F,7,8,1,7
59B,6/16/21,0.0625,1,1,F,8,9,0,9
59B,6/16/21,0.03125,1,1,F,9,13,7,6
59B,6/16/21,0.015625,1,1,F,10,13,2,11
VC,6/16/21,0,1,1,F,12,7,0,7
93A,6/16/21,16,1,1,G,1,10,10,0
93A,6/16/21,8,1,1,G,2,11,10,1
93A,6/16/21,4,1,1,G,3,10,9,1
93A,6/16/21,2,1,1,G,4,8,8,0
93A,6/16/21,1,1,1,G,5,12,10,2
93A,6/16/21,0.5,1,1,G,6,12,10,2
93A,6/16/21,0.25,1,1,G,7,9,4,5
93A,6/16/21,0.125,1,1,G,8,8,2,6
93A,6/16/21,0.0625,1,1,G,9,12,1,11
93A,6/16/21,0.03125,1,1,G,10,1,0,1
VC,6/16/21,0,1,1,G,12,9,0,9
1036-14B,6/16/21,1.28,1,1,H,1,5,5,0
1036-14B,6/16/21,0.64,1,1,H,2,6,5,1
1036-14B,6/16/21,0.32,1,1,H,3,11,2,9
1036-14B,6/16/21,0.16,1,1,H,4,13,3,10
1036-14B,6/16/21,0.08,1,1,H,5,7,3,4
1036-14B,6/16/21,0.04,1,1,H,6,8,0,8
1036-14B,6/16/21,0.02,1,1,H,7,9,3,6
1036-14B,6/16/21,0.01,1,1,H,8,7,1,6
1036-14B,6/16/21,0.005,1,1,H,9,10,0,10
1036-14B,6/16/21,0.0025,1,1,H,10,8,2,6
VC,6/16/21,0,1,1,H,12,5,0,5
35L,6/24/21,1.28,1,1,A,1,5,2,3
35L,6/24/21,0.64,1,1,A,2,5,1,4
35L,6/24/21,0.32,1,1,A,3,6,3,3
35L,6/24/21,0.16,1,1,A,4,5,1,4
35L,6/24/21,0.08,1,1,A,5,8,0,8
35L,6/24/21,0.04,1,1,A,6,8,3,5
35L,6/24/21,0.02,1,1,A,7,11,2,9
35L,6/24/21,0.01,1,1,A,8,10,2,8
35L,6/24/21,0.005,1,1,A,9,7,1,6
35L,6/24/21,0.0025,1,1,A,10,7,0,7
VC,6/24/21,0,1,1,A,12,14,2,12
38A,6/24/21,16,1,1,B,1,13,13,0
38A,6/24/21,8,1,1,B,2,10,10,0
38A,6/24/21,4,1,1,B,3,12,10,2
38A,6/24/21,2,1,1,B,4,9,7,2
38A,6/24/21,1,1,1,B,5,10,10,0
38A,6/24/21,0.5,1,1,B,6,11,8,3
38A,6/24/21,0.25,1,1,B,7,12,8,4
38A,6/24/21,0.125,1,1,B,8,9,4,5
38A,6/24/21,0.0625,1,1,B,9,13,2,11
38A,6/24/21,0.03125,1,1,B,10,10,2,8
VC,6/24/21,0,1,1,B,12,8,0,8
59E,6/24/21,8,1,1,C,1,6,4,2
59E,6/24/21,4,1,1,C,2,12,7,5
59E,6/24/21,2,1,1,C,3,10,5,5
59E,6/24/21,1,1,1,C,4,8,5,3
59E,6/24/21,0.5,1,1,C,5,12,2,10
59E,6/24/21,0.25,1,1,C,6,8,4,4
59E,6/24/21,0.125,1,1,C,7,12,4,8
59E,6/24/21,0.0625,1,1,C,8,10,2,8
59E,6/24/21,0.03125,1,1,C,9,12,7,5
59E,6/24/21,0.015625,1,1,C,10,10,0,10
VC,6/24/21,0,1,1,C,12,11,3,8
59D,6/24/21,8,1,1,D,1,10,8,2
59D,6/24/21,4,1,1,D,2,9,5,4
59D,6/24/21,2,1,1,D,3,13,11,2
59D,6/24/21,1,1,1,D,4,12,8,4
59D,6/24/21,0.5,1,1,D,5,9,7,2
59D,6/24/21,0.25,1,1,D,6,13,10,3
59D,6/24/21,0.125,1,1,D,7,7,0,7
59D,6/24/21,0.0625,1,1,D,8,11,3,8
59D,6/24/21,0.03125,1,1,D,9,8,2,6
59D,6/24/21,0.015625,1,1,D,10,7,2,5
VC,6/24/21,0,1,1,D,12,12,0,12
1036-14B,6/24/21,1.28,1,1,E,1,11,11,0
1036-14B,6/24/21,0.64,1,1,E,2,13,7,6
1036-14B,6/24/21,0.32,1,1,E,3,15,10,5
1036-14B,6/24/21,0.16,1,1,E,4,9,1,8
1036-14B,6/24/21,0.08,1,1,E,5,5,0,5
1036-14B,6/24/21,0.04,1,1,E,6,9,1,8
1036-14B,6/24/21,0.02,1,1,E,7,15,2,13
1036-14B,6/24/21,0.01,1,1,E,8,13,1,12
1036-14B,6/24/21,0.005,1,1,E,9,15,2,13
1036-14B,6/24/21,0.0025,1,1,E,10,10,0,10
VC,6/24/21,0,1,1,E,12,16,3,13
59G,6/24/21,16,1,1,F,1,12,4,8
59G,6/24/21,8,1,1,F,2,8,1,7
59G,6/24/21,4,1,1,F,3,12,0,12
59G,6/24/21,2,1,1,F,4,11,0,11
59G,6/24/21,1,1,1,F,5,15,5,10
59G,6/24/21,0.5,1,1,F,6,11,5,6
59G,6/24/21,0.25,1,1,F,7,12,1,11
59G,6/24/21,0.125,1,1,F,8,14,2,12
59G,6/24/21,0.0625,1,1,F,9,13,3,10
59G,6/24/21,0.03125,1,1,F,10,11,1,10
VC,6/24/21,0,1,1,F,12,16,2,14
38F,6/24/21,8,1,1,G,1,12,4,8
38F,6/24/21,4,1,1,G,2,9,3,6
38F,6/24/21,2,1,1,G,3,11,7,4
38F,6/24/21,1,1,1,G,4,10,0,10
38F,6/24/21,0.5,1,1,G,5,7,2,5
38F,6/24/21,0.25,1,1,G,6,7,1,6
38F,6/24/21,0.125,1,1,G,7,12,2,10
38F,6/24/21,0.0625,1,1,G,8,11,1,10
38F,6/24/21,0.03125,1,1,G,9,10,3,7
38F,6/24/21,0.015625,1,1,G,10,11,0,11
VC,6/24/21,0,1,1,G,12,8,1,7
59C,6/24/21,8,1,1,H,1,11,1,10
59C,6/24/21,4,1,1,H,2,8,0,8
59C,6/24/21,2,1,1,H,3,12,1,11
59C,6/24/21,1,1,1,H,4,11,2,9
59C,6/24/21,0.5,1,1,H,5,10,0,10
59C,6/24/21,0.25,1,1,H,6,12,2,10
59C,6/24/21,0.125,1,1,H,7,13,1,12
59C,6/24/21,0.0625,1,1,H,8,8,1,7
59C,6/24/21,0.03125,1,1,H,9,0,,
59C,6/24/21,0.015625,1,1,H,10,10,2,8
VC,6/24/21,0,1,1,H,12,9,2,7
59G,6/30/21,16,1,1,A,1,13,2,11
59G,6/30/21,8,1,1,A,2,10,4,6
59G,6/30/21,4,1,1,A,3,12,3,9
59G,6/30/21,2,1,1,A,4,6,4,2
59G,6/30/21,1,1,1,A,5,11,3,8
59G,6/30/21,0.5,1,1,A,6,13,3,10
59G,6/30/21,0.25,1,1,A,7,12,3,9
59G,6/30/21,0.125,1,1,A,8,9,5,4
59G,6/30/21,0.0625,1,1,A,9,20,3,17
59G,6/30/21,0.03125,1,1,A,10,14,3,11
VC,6/30/21,0,1,1,A,12,11,5,6
59A,6/30/21,8,1,1,B,1,8,0,8
59A,6/30/21,4,1,1,B,2,16,9,7
59A,6/30/21,2,1,1,B,3,12,11,1
59A,6/30/21,1,1,1,B,4,12,8,4
59A,6/30/21,0.5,1,1,B,5,14,7,7
59A,6/30/21,0.25,1,1,B,6,12,6,6
59A,6/30/21,0.125,1,1,B,7,12,6,6
59A,6/30/21,0.0625,1,1,B,8,9,6,3
59A,6/30/21,0.03125,1,1,B,9,22,5,17
59A,6/30/21,0.015625,1,1,B,10,16,4,12
VC,6/30/21,0,1,1,B,12,11,2,9
59E,6/30/21,8,1,1,C,1,13,4,9
59E,6/30/21,4,1,1,C,2,10,3,7
59E,6/30/21,2,1,1,C,3,18,2,16
59E,6/30/21,1,1,1,C,4,14,2,12
59E,6/30/21,0.5,1,1,C,5,8,1,7
59E,6/30/21,0.25,1,1,C,6,14,3,11
59E,6/30/21,0.125,1,1,C,7,14,4,10
59E,6/30/21,0.0625,1,1,C,8,11,7,4
59E,6/30/21,0.03125,1,1,C,9,14,4,10
59E,6/30/21,0.015625,1,1,C,10,14,1,13
VC,6/30/21,0,1,1,C,12,15,6,9
59C,6/30/21,8,1,1,D,1,13,2,11
59C,6/30/21,4,1,1,D,2,17,5,12
59C,6/30/21,2,1,1,D,3,11,6,5
59C,6/30/21,1,1,1,D,4,17,4,13
59C,6/30/21,0.5,1,1,D,5,8,0,8
59C,6/30/21,0.25,1,1,D,6,13,2,11
59C,6/30/21,0.125,1,1,D,7,17,5,12
59C,6/30/21,0.0625,1,1,D,8,13,0,13
59C,6/30/21,0.03125,1,1,D,9,8,1,7
59C,6/30/21,0.015625,1,1,D,10,20,7,13
VC,6/30/21,0,1,1,D,12,8,2,6
59D,6/30/21,8,1,1,E,1,13,0,13
59D,6/30/21,4,1,1,E,2,14,12,2
59D,6/30/21,2,1,1,E,3,6,5,1
59D,6/30/21,1,1,1,E,4,9,6,3
59D,6/30/21,0.5,1,1,E,5,9,6,3
59D,6/30/21,0.25,1,1,E,6,19,16,3
59D,6/30/21,0.125,1,1,E,7,17,15,2
59D,6/30/21,0.0625,1,1,E,8,9,1,8
59D,6/30/21,0.03125,1,1,E,9,24,11,13
59D,6/30/21,0.015625,1,1,E,10,15,5,10
VC,6/30/21,0,1,1,E,12,16,2,14
38F,6/30/21,8,1,1,F,1,12,8,4
38F,6/30/21,4,1,1,F,2,7,0,7
38F,6/30/21,2,1,1,F,3,5,2,3
38F,6/30/21,1,1,1,F,4,7,0,7
38F,6/30/21,0.5,1,1,F,5,8,2,6
38F,6/30/21,0.25,1,1,F,6,12,1,11
38F,6/30/21,0.125,1,1,F,7,16,4,12
38F,6/30/21,0.0625,1,1,F,8,13,0,13
38F,6/30/21,0.03125,1,1,F,9,8,2,6
38F,6/30/21,0.015625,1,1,F,10,11,2,9
VC,6/30/21,0,1,1,F,12,8,1,7
1036-38A,6/30/21,16,1,1,G,1,11,11,0
1036-38A,6/30/21,8,1,1,G,2,12,9,3
1036-38A,6/30/21,4,1,1,G,3,11,8,3
1036-38A,6/30/21,2,1,1,G,4,6,4,2
1036-38A,6/30/21,1,1,1,G,5,20,14,6
1036-38A,6/30/21,0.5,1,1,G,6,14,13,1
1036-38A,6/30/21,0.25,1,1,G,7,8,4,4
1036-38A,6/30/21,0.125,1,1,G,8,15,8,7
1036-38A,6/30/21,0.0625,1,1,G,9,7,2,5
1036-38A,6/30/21,0.03125,1,1,G,10,21,9,12
VC,6/30/21,0,1,1,G,12,12,5,7
1036-14B,6/30/21,1.28,1,1,H,1,14,13,1
1036-14B,6/30/21,0.64,1,1,H,2,12,5,7
1036-14B,6/30/21,0.32,1,1,H,3,8,2,6
1036-14B,6/30/21,0.16,1,1,H,4,8,3,5
1036-14B,6/30/21,0.08,1,1,H,5,19,3,16
1036-14B,6/30/21,0.04,1,1,H,6,18,5,13
1036-14B,6/30/21,0.02,1,1,H,7,11,7,4
1036-14B,6/30/21,0.01,1,1,H,8,12,5,7
1036-14B,6/30/21,0.005,1,1,H,9,7,3,4
1036-14B,6/30/21,0.0025,1,1,H,10,10,2,8
VC,6/30/21,0,1,1,H,12,11,0,11
1036-94A,7/1/21,124.5,1,1,A,1,10,0,10
1036-94A,7/1/21,62.25,1,1,A,2,14,0,14
1036-94A,7/1/21,31.125,1,1,A,3,8,4,4
1036-94A,7/1/21,15.5625,1,1,A,4,9,2,7
1036-94A,7/1/21,7.78125,1,1,A,5,15,2,13
1036-94A,7/1/21,3.890625,1,1,A,6,15,12,3
1036-94A,7/1/21,1.9453125,1,1,A,7,10,4,6
1036-94A,7/1/21,0.97265625,1,1,A,8,12,1,11
1036-94A,7/1/21,0.486328125,1,1,A,9,8,4,4
1036-94A,7/1/21,0.243164063,1,1,A,10,4,1,3
VC,7/1/21,0,1,1,A,12,7,1,6
1036-94B,7/1/21,135.5,1,1,B,1,18,2,16
1036-94B,7/1/21,67.75,1,1,B,2,14,0,14
1036-94B,7/1/21,33.875,1,1,B,3,15,3,12
1036-94B,7/1/21,16.9375,1,1,B,4,9,1,8
1036-94B,7/1/21,8.46875,1,1,B,5,6,1,5
1036-94B,7/1/21,4.234375,1,1,B,6,13,1,12
1036-94B,7/1/21,2.1171875,1,1,B,7,12,2,10
1036-94B,7/1/21,1.05859375,1,1,B,8,14,5,9
1036-94B,7/1/21,0.529296875,1,1,B,9,10,3,7
1036-94B,7/1/21,0.264648438,1,1,B,10,10,3,7
VC,7/1/21,0,1,1,B,12,15,1,14
1036-94D,7/1/21,128.5,1,1,C,1,7,0,7
1036-94D,7/1/21,64.25,1,1,C,2,8,0,8
1036-94D,7/1/21,32.125,1,1,C,3,9,0,9
1036-94D,7/1/21,16.0625,1,1,C,4,5,1,4
1036-94D,7/1/21,8.03125,1,1,C,5,11,1,10
1036-94D,7/1/21,4.015625,1,1,C,6,13,1,12
1036-94D,7/1/21,2.0078125,1,1,C,7,12,1,11
1036-94D,7/1/21,1.00390625,1,1,C,8,11,2,9
1036-94D,7/1/21,0.501953125,1,1,C,9,14,2,12
1036-94D,7/1/21,0.250976563,1,1,C,10,9,2,7
VC,7/1/21,0,1,1,C,12,14,5,9
1036-14B,7/1/21,1.28,1,1,D,1,14,14,0
1036-14B,7/1/21,0.64,1,1,D,2,12,12,0
1036-14B,7/1/21,0.32,1,1,D,3,5,3,2
1036-14B,7/1/21,0.16,1,1,D,4,10,1,9
1036-14B,7/1/21,0.08,1,1,D,5,20,0,20
1036-14B,7/1/21,0.04,1,1,D,6,11,3,8
1036-14B,7/1/21,0.02,1,1,D,7,10,0,10
1036-14B,7/1/21,0.01,1,1,D,8,10,2,8
1036-14B,7/1/21,0.005,1,1,D,9,7,4,3
1036-14B,7/1/21,0.0025,1,1,D,10,9,6,3
VC,7/1/21,0,1,1,D,12,13,3,10
1036-94E,7/1/21,132,1,1,E,1,12,2,10
1036-94E,7/1/21,66,1,1,E,2,7,1,6
1036-94E,7/1/21,33,1,1,E,3,7,1,6
1036-94E,7/1/21,16.5,1,1,E,4,6,2,4
1036-94E,7/1/21,8.25,1,1,E,5,7,1,6
1036-94E,7/1/21,4.125,1,1,E,6,5,1,4
1036-94E,7/1/21,2.0625,1,1,E,7,7,1,6
1036-94E,7/1/21,1.03125,1,1,E,8,8,1,7
1036-94E,7/1/21,0.515625,1,1,E,9,12,3,9
1036-94E,7/1/21,0.2578125,1,1,E,10,16,4,12
VC,7/1/21,0,1,1,E,12,11,3,8
1036-94C,7/14/21,128.5,1,1,A,1,17,1,16
1036-94C,7/14/21,64.25,1,1,A,2,26,0,26
1036-94C,7/14/21,32.125,1,1,A,3,14,2,12
1036-94C,7/14/21,16.0625,1,1,A,4,11,4,7
1036-94C,7/14/21,8.03125,1,1,A,5,12,1,11
1036-94C,7/14/21,4.015625,1,1,A,6,20,2,18
1036-94C,7/14/21,2.0078125,1,1,A,7,23,1,22
1036-94C,7/14/21,1.00390625,1,1,A,8,24,3,21
1036-94C,7/14/21,0.501953125,1,1,A,9,18,0,18
1036-94C,7/14/21,0.250976563,1,1,A,10,26,3,23
VC,7/14/21,0,1,1,A,12,18,0,18
1036-94F,7/14/21,147,1,1,B,1,5,3,2
1036-94F,7/14/21,73.5,1,1,B,2,16,6,10
1036-94F,7/14/21,36.75,1,1,B,3,24,3,21
1036-94F,7/14/21,18.375,1,1,B,4,12,1,11
1036-94F,7/14/21,9.1875,1,1,B,5,23,3,20
1036-94F,7/14/21,4.59375,1,1,B,6,18,1,17
1036-94F,7/14/21,2.296875,1,1,B,7,21,3,18
1036-94F,7/14/21,1.1484375,1,1,B,8,19,4,15
1036-94F,7/14/21,0.57421875,1,1,B,9,12,1,11
1036-94F,7/14/21,0.287109375,1,1,B,10,25,3,22
VC,7/14/21,0,1,1,B,12,12,2,10
1036-94G,7/14/21,64,1,1,C,1,16,6,10
1036-94G,7/14/21,32,1,1,C,2,20,2,18
1036-94G,7/14/21,16,1,1,C,3,12,0,12
1036-94G,7/14/21,8,1,1,C,4,12,0,12
1036-94G,7/14/21,4,1,1,C,5,8,1,7
1036-94G,7/14/21,2,1,1,C,6,11,0,11
1036-94G,7/14/21,1,1,1,C,7,18,5,13
1036-94G,7/14/21,0.5,1,1,C,8,16,0,16
1036-94G,7/14/21,0.25,1,1,C,9,16,2,14
1036-94G,7/14/21,0.125,1,1,C,10,11,0,11
VC,7/14/21,0,1,1,C,12,13,0,13
1036-14B,7/14/21,1.28,1,1,D,1,19,17,2
1036-14B,7/14/21,0.64,1,1,D,2,18,15,3
1036-14B,7/14/21,0.32,1,1,D,3,14,9,5
1036-14B,7/14/21,0.16,1,1,D,4,13,2,11
1036-14B,7/14/21,0.08,1,1,D,5,11,4,7
1036-14B,7/14/21,0.04,1,1,D,6,19,2,17
1036-14B,7/14/21,0.02,1,1,D,7,16,1,15
1036-14B,7/14/21,0.01,1,1,D,8,26,4,22
1036-14B,7/14/21,0.005,1,1,D,9,20,3,17
1036-14B,7/14/21,0.0025,1,1,D,10,18,4,14
VC,7/14/21,0,1,1,D,12,11,0,11
35L,7/14/21,1.28,1,1,E,1,9,0,9
35L,7/14/21,0.64,1,1,E,2,13,3,10
35L,7/14/21,0.32,1,1,E,3,15,3,12
35L,7/14/21,0.16,1,1,E,4,13,4,9
35L,7/14/21,0.08,1,1,E,5,13,1,12
35L,7/14/21,0.04,1,1,E,6,14,0,14
35L,7/14/21,0.02,1,1,E,7,17,4,13
35L,7/14/21,0.01,1,1,E,8,21,2,19
35L,7/14/21,0.005,1,1,E,9,17,2,15
35L,7/14/21,0.0025,1,1,E,10,11,0,11
VC,7/14/21,0,1,1,E,12,11,1,10
38A,7/14/21,16,1,1,F,1,17,17,0
38A,7/14/21,8,1,1,F,2,9,9,0
38A,7/14/21,4,1,1,F,3,13,12,1
38A,7/14/21,2,1,1,F,4,14,9,5
38A,7/14/21,1,1,1,F,5,11,3,8
38A,7/14/21,0.5,1,1,F,6,13,11,2
38A,7/14/21,0.25,1,1,F,7,18,8,10
38A,7/14/21,0.125,1,1,F,8,27,15,12
38A,7/14/21,0.0625,1,1,F,9,21,5,16
38A,7/14/21,0.03125,1,1,F,10,20,5,15
VC,7/14/21,0,1,1,F,12,11,3,8
38F,7/14/21,8,1,1,G,1,9,3,6
38F,7/14/21,4,1,1,G,2,21,9,12
38F,7/14/21,2,1,1,G,3,18,10,8
38F,7/14/21,1,1,1,G,4,22,9,13
38F,7/14/21,0.5,1,1,G,5,17,3,14
38F,7/14/21,0.25,1,1,G,6,23,1,22
38F,7/14/21,0.125,1,1,G,7,15,3,12
38F,7/14/21,0.0625,1,1,G,8,28,3,25
38F,7/14/21,0.03125,1,1,G,9,17,5,12
38F,7/14/21,0.015625,1,1,G,10,21,4,17
VC,7/14/21,0,1,1,G,12,18,2,16
35H,7/14/21,1.28,1,1,H,1,17,8,9
35H,7/14/21,0.64,1,1,H,2,19,10,9
35H,7/14/21,0.32,1,1,H,3,12,2,10
35H,7/14/21,0.16,1,1,H,4,18,2,16
35H,7/14/21,0.08,1,1,H,5,17,1,16
35H,7/14/21,0.04,1,1,H,6,15,1,14
35H,7/14/21,0.02,1,1,H,7,21,4,17
35H,7/14/21,0.01,1,1,H,8,28,2,26
35H,7/14/21,0.005,1,1,H,9,18,2,16
35H,7/14/21,0.0025,1,1,H,10,20,2,18
VC,7/14/21,0,1,1,H,12,12,7,5
59C,7/15/21,8,1,1,A,1,3,0,3
59C,7/15/21,4,1,1,A,2,13,2,11
59C,7/15/21,2,1,1,A,3,11,7,4
59C,7/15/21,1,1,1,A,4,14,5,9
59C,7/15/21,0.5,1,1,A,5,14,9,5
59C,7/15/21,0.25,1,1,A,6,17,7,10
59C,7/15/21,0.125,1,1,A,7,13,2,11
59C,7/15/21,0.0625,1,1,A,8,12,1,11
59C,7/15/21,0.03125,1,1,A,9,7,0,7
59C,7/15/21,0.015625,1,1,A,10,13,1,12
VC,7/15/21,0,1,1,A,12,11,1,10
38L,7/15/21,10.24,1,1,B,1,9,0,9
38L,7/15/21,5.12,1,1,B,2,16,0,16
38L,7/15/21,2.56,1,1,B,3,16,15,1
38L,7/15/21,1.28,1,1,B,4,12,9,3
38L,7/15/21,0.64,1,1,B,5,19,15,4
38L,7/15/21,0.32,1,1,B,6,16,13,3
38L,7/15/21,0.16,1,1,B,7,17,16,1
38L,7/15/21,0.08,1,1,B,8,16,14,2
38L,7/15/21,0.04,1,1,B,9,10,7,3
38L,7/15/21,0.02,1,1,B,10,14,9,5
VC,7/15/21,0,1,1,B,12,7,3,4
38K,7/15/21,1024,1,1,C,1,8,8,0
38K,7/15/21,512,1,1,C,2,11,11,0
38K,7/15/21,256,1,1,C,3,10,10,0
38K,7/15/21,128,1,1,C,4,15,15,0
38K,7/15/21,64,1,1,C,5,14,14,0
38K,7/15/21,32,1,1,C,6,16,14,2
38K,7/15/21,16,1,1,C,7,23,22,1
38K,7/15/21,8,1,1,C,8,15,11,4
38K,7/15/21,4,1,1,C,9,7,7,0
38K,7/15/21,2,1,1,C,10,4,4,0
VC,7/15/21,0,1,1,C,12,12,1,11
38A,7/15/21,16,1,1,D,1,9,9,0
38A,7/15/21,8,1,1,D,2,21,21,0
38A,7/15/21,4,1,1,D,3,18,15,3
38A,7/15/21,2,1,1,D,4,23,19,4
38A,7/15/21,1,1,1,D,5,13,8,5
38A,7/15/21,0.5,1,1,D,6,16,14,2
38A,7/15/21,0.25,1,1,D,7,14,10,4
38A,7/15/21,0.125,1,1,D,8,13,4,9
38A,7/15/21,0.0625,1,1,D,9,16,2,14
38A,7/15/21,0.03125,1,1,D,10,5,1,4
VC,7/15/21,0,1,1,D,12,12,2,10
38N,7/15/21,1.28,1,1,E,1,13,12,1
38N,7/15/21,0.64,1,1,E,2,17,13,4
38N,7/15/21,0.32,1,1,E,3,8,5,3
38N,7/15/21,0.16,1,1,E,4,13,11,2
38N,7/15/21,0.08,1,1,E,5,24,16,8
38N,7/15/21,0.04,1,1,E,6,14,12,2
38N,7/15/21,0.02,1,1,E,7,13,10,3
38N,7/15/21,0.01,1,1,E,8,10,5,5
38N,7/15/21,0.005,1,1,E,9,12,2,10
38N,7/15/21,0.0025,1,1,E,10,7,2,5
VC,7/15/21,0,1,1,E,12,8,0,8
59B,7/15/21,8,1,1,F,1,8,8,0
59B,7/15/21,4,1,1,F,2,13,11,2
59B,7/15/21,2,1,1,F,3,13,10,3
59B,7/15/21,1,1,1,F,4,19,12,7
59B,7/15/21,0.5,1,1,F,5,27,19,8
59B,7/15/21,0.25,1,1,F,6,24,14,10
59B,7/15/21,0.125,1,1,F,7,18,2,16
59B,7/15/21,0.0625,1,1,F,8,10,1,9
59B,7/15/21,0.03125,1,1,F,9,9,1,8
59B,7/15/21,0.015625,1,1,F,10,14,1,13
VC,7/15/21,0,1,1,F,12,6,1,5
59G,7/15/21,16,1,1,G,1,4,1,3
59G,7/15/21,8,1,1,G,2,9,1,8
59G,7/15/21,4,1,1,G,3,20,4,16
59G,7/15/21,2,1,1,G,4,22,14,8
59G,7/15/21,1,1,1,G,5,22,18,4
59G,7/15/21,0.5,1,1,G,6,17,14,3
59G,7/15/21,0.25,1,1,G,7,18,9,9
59G,7/15/21,0.125,1,1,G,8,13,0,13
59G,7/15/21,0.0625,1,1,G,9,9,0,9
59G,7/15/21,0.03125,1,1,G,10,14,1,13
VC,7/15/21,0,1,1,G,12,10,2,8
1036-14B,7/15/21,1.28,1,1,H,1,11,10,1
1036-14B,7/15/21,0.64,1,1,H,2,13,11,2
1036-14B,7/15/21,0.32,1,1,H,3,14,14,0
1036-14B,7/15/21,0.16,1,1,H,4,18,16,2
1036-14B,7/15/21,0.08,1,1,H,5,12,9,3
1036-14B,7/15/21,0.04,1,1,H,6,21,14,7
1036-14B,7/15/21,0.02,1,1,H,7,12,3,9
1036-14B,7/15/21,0.01,1,1,H,8,6,2,4
1036-14B,7/15/21,0.005,1,1,H,9,7,2,5
1036-14B,7/15/21,0.0025,1,1,H,10,7,4,3
VC,7/15/21,0,1,1,H,12,15,1,14
59E,7/15/21,8,1,2,A,1,8,4,4
59E,7/15/21,4,1,2,A,2,7,4,3
59E,7/15/21,2,1,2,A,3,7,6,1
59E,7/15/21,1,1,2,A,4,9,4,5
59E,7/15/21,0.5,1,2,A,5,8,4,4
59E,7/15/21,0.25,1,2,A,6,10,5,5
59E,7/15/21,0.125,1,2,A,7,9,2,7
59E,7/15/21,0.0625,1,2,A,8,9,1,8
59E,7/15/21,0.03125,1,2,A,9,3,0,3
59E,7/15/21,0.015625,1,2,A,10,7,1,6
VC,7/15/21,0,1,2,A,12,8,1,7
59A,7/15/21,8,1,2,B,1,5,5,0
59A,7/15/21,4,1,2,B,2,5,5,0
59A,7/15/21,2,1,2,B,3,11,8,3
59A,7/15/21,1,1,2,B,4,6,6,0
59A,7/15/21,0.5,1,2,B,5,11,10,1
59A,7/15/21,0.25,1,2,B,6,9,2,7
59A,7/15/21,0.125,1,2,B,7,8,3,5
59A,7/15/21,0.0625,1,2,B,8,11,0,11
59A,7/15/21,0.03125,1,2,B,9,5,1,4
59A,7/15/21,0.015625,1,2,B,10,12,2,10
VC,7/15/21,0,1,2,B,12,10,2,8
38F,7/15/21,8,1,2,C,1,13,4,9
38F,7/15/21,4,1,2,C,2,10,6,4
38F,7/15/21,2,1,2,C,3,9,8,1
38F,7/15/21,1,1,2,C,4,6,4,2
38F,7/15/21,0.5,1,2,C,5,13,10,3
38F,7/15/21,0.25,1,2,C,6,11,6,5
38F,7/15/21,0.125,1,2,C,7,16,3,13
38F,7/15/21,0.0625,1,2,C,8,6,1,5
38F,7/15/21,0.03125,1,2,C,9,6,1,5
38F,7/15/21,0.015625,1,2,C,10,12,8,4
VC,7/15/21,0,1,2,C,12,18,2,16
1036-14B,7/15/21,1.28,1,2,D,1,11,10,1
1036-14B,7/15/21,0.64,1,2,D,2,8,8,0
1036-14B,7/15/21,0.32,1,2,D,3,16,14,2
1036-14B,7/15/21,0.16,1,2,D,4,13,11,2
1036-14B,7/15/21,0.08,1,2,D,5,10,9,1
1036-14B,7/15/21,0.04,1,2,D,6,6,4,2
1036-14B,7/15/21,0.02,1,2,D,7,9,2,7
1036-14B,7/15/21,0.01,1,2,D,8,18,1,17
1036-14B,7/15/21,0.005,1,2,D,9,20,16,4
1036-14B,7/15/21,0.0025,1,2,D,10,15,1,14
VC,7/15/21,0,1,2,D,12,8,3,5
59C,7/16/21,8,1,1,A,1,11,2,9
59C,7/16/21,4,1,1,A,2,8,0,8
59C,7/16/21,2,1,1,A,3,7,1,6
59C,7/16/21,1,1,1,A,4,14,2,12
59C,7/16/21,0.5,1,1,A,5,11,0,11
59C,7/16/21,0.25,1,1,A,6,9,0,9
59C,7/16/21,0.125,1,1,A,7,12,1,11
59C,7/16/21,0.0625,1,1,A,8,5,0,5
59C,7/16/21,0.03125,1,1,A,9,9,2,7
59C,7/16/21,0.015625,1,1,A,10,6,2,4
VC,7/16/21,0,1,1,A,12,10,2,8
38L,7/16/21,10.24,1,1,B,1,10,10,0
38L,7/16/21,5.12,1,1,B,2,8,7,1
38L,7/16/21,2.56,1,1,B,3,10,10,0
38L,7/16/21,1.28,1,1,B,4,7,7,0
38L,7/16/21,0.64,1,1,B,5,9,8,1
38L,7/16/21,0.32,1,1,B,6,11,8,3
38L,7/16/21,0.16,1,1,B,7,19,17,2
38L,7/16/21,0.08,1,1,B,8,14,12,2
38L,7/16/21,0.04,1,1,B,9,10,7,3
38L,7/16/21,0.02,1,1,B,10,9,8,1
VC,7/16/21,0,1,1,B,12,13,0,13
59E,7/16/21,8,1,1,C,1,19,16,3
59E,7/16/21,4,1,1,C,2,13,8,5
59E,7/16/21,2,1,1,C,3,8,5,3
59E,7/16/21,1,1,1,C,4,14,4,10
59E,7/16/21,0.5,1,1,C,5,13,10,3
59E,7/16/21,0.25,1,1,C,6,10,6,4
59E,7/16/21,0.125,1,1,C,7,17,7,10
59E,7/16/21,0.0625,1,1,C,8,12,4,8
59E,7/16/21,0.03125,1,1,C,9,13,0,13
59E,7/16/21,0.015625,1,1,C,10,17,9,8
VC,7/16/21,0,1,1,C,12,9,2,7
38A,7/16/21,16,1,1,D,1,14,0,14
38A,7/16/21,8,1,1,D,2,8,6,2
38A,7/16/21,4,1,1,D,3,7,3,4
38A,7/16/21,2,1,1,D,4,8,6,2
38A,7/16/21,1,1,1,D,5,17,15,2
38A,7/16/21,0.5,1,1,D,6,19,11,8
38A,7/16/21,0.25,1,1,D,7,12,9,3
38A,7/16/21,0.125,1,1,D,8,12,7,5
38A,7/16/21,0.0625,1,1,D,9,15,3,12
38A,7/16/21,0.03125,1,1,D,10,10,1,9
VC,7/16/21,0,1,1,D,12,8,3,5
38N,7/16/21,1.28,1,1,E,1,11,10,1
38N,7/16/21,0.64,1,1,E,2,9,9,0
38N,7/16/21,0.32,1,1,E,3,6,6,0
38N,7/16/21,0.16,1,1,E,4,6,6,0
38N,7/16/21,0.08,1,1,E,5,13,11,2
38N,7/16/21,0.04,1,1,E,6,10,2,8
38N,7/16/21,0.02,1,1,E,7,8,3,5
38N,7/16/21,0.01,1,1,E,8,14,1,13
38N,7/16/21,0.005,1,1,E,9,7,1,6
38N,7/16/21,0.0025,1,1,E,10,9,2,7
VC,7/16/21,0,1,1,E,12,5,0,5
59B,7/16/21,8,1,1,F,1,12,11,1
59B,7/16/21,4,1,1,F,2,12,12,0
59B,7/16/21,2,1,1,F,3,19,17,2
59B,7/16/21,1,1,1,F,4,13,5,8
59B,7/16/21,0.5,1,1,F,5,4,2,2
59B,7/16/21,0.25,1,1,F,6,15,2,13
59B,7/16/21,0.125,1,1,F,7,12,2,10
59B,7/16/21,0.0625,1,1,F,8,24,2,22
59B,7/16/21,0.03125,1,1,F,9,11,1,10
59B,7/16/21,0.015625,1,1,F,10,11,1,10
VC,7/16/21,0,1,1,F,12,11,2,9
59G,7/16/21,16,1,1,G,1,8,3,5
59G,7/16/21,8,1,1,G,2,16,3,13
59G,7/16/21,4,1,1,G,3,12,2,10
59G,7/16/21,2,1,1,G,4,15,1,14
59G,7/16/21,1,1,1,G,5,14,1,13
59G,7/16/21,0.5,1,1,G,6,15,5,10
59G,7/16/21,0.25,1,1,G,7,19,8,11
59G,7/16/21,0.125,1,1,G,8,14,2,12
59G,7/16/21,0.0625,1,1,G,9,13,3,10
59G,7/16/21,0.03125,1,1,G,10,21,12,9
VC,7/16/21,0,1,1,G,12,14,1,13
1036-14B,7/16/21,1.28,1,1,H,1,9,8,1
1036-14B,7/16/21,0.64,1,1,H,2,17,16,1
1036-14B,7/16/21,0.32,1,1,H,3,18,9,9
1036-14B,7/16/21,0.16,1,1,H,4,13,2,11
1036-14B,7/16/21,0.08,1,1,H,5,11,2,9
1036-14B,7/16/21,0.04,1,1,H,6,16,1,15
1036-14B,7/16/21,0.02,1,1,H,7,11,2,9
1036-14B,7/16/21,0.01,1,1,H,8,16,1,15
1036-14B,7/16/21,0.005,1,1,H,9,17,1,16
1036-14B,7/16/21,0.0025,1,1,H,10,14,2,12
VC,7/16/21,0,1,1,H,12,9,3,6
59A,7/16/21,8,1,2,A,1,9,8,1
59A,7/16/21,4,1,2,A,2,14,13,1
59A,7/16/21,2,1,2,A,3,14,13,1
59A,7/16/21,1,1,2,A,4,5,4,1
59A,7/16/21,0.5,1,2,A,5,14,7,7
59A,7/16/21,0.25,1,2,A,6,9,6,3
59A,7/16/21,0.125,1,2,A,7,11,6,5
59A,7/16/21,0.0625,1,2,A,8,14,5,9
59A,7/16/21,0.03125,1,2,A,9,14,1,13
59A,7/16/21,0.015625,1,2,A,10,16,3,13
VC,7/16/21,0,1,2,A,12,11,2,9
38F,7/16/21,8,1,2,B,1,15,4,11
38F,7/16/21,4,1,2,B,2,17,5,12
38F,7/16/21,2,1,2,B,3,14,1,13
38F,7/16/21,1,1,2,B,4,11,1,10
38F,7/16/21,0.5,1,2,B,5,13,1,12
38F,7/16/21,0.25,1,2,B,6,12,3,9
38F,7/16/21,0.125,1,2,B,7,14,0,14
38F,7/16/21,0.0625,1,2,B,8,15,4,11
38F,7/16/21,0.03125,1,2,B,9,11,3,8
38F,7/16/21,0.015625,1,2,B,10,12,4,8
VC,7/16/21,0,1,2,B,12,9,2,7
93A,7/16/21,16,1,2,C,1,10,5,5
93A,7/16/21,8,1,2,C,2,8,6,2
93A,7/16/21,4,1,2,C,3,15,12,3
93A,7/16/21,2,1,2,C,4,11,3,8
93A,7/16/21,1,1,2,C,5,13,7,6
93A,7/16/21,0.5,1,2,C,6,15,7,8
93A,7/16/21,0.25,1,2,C,7,21,10,11
93A,7/16/21,0.125,1,2,C,8,12,7,5
93A,7/16/21,0.0625,1,2,C,9,14,6,8
93A,7/16/21,0.03125,1,2,C,10,16,13,3
VC,7/16/21,0,1,2,C,12,10,3,7
93B,7/16/21,139,1,2,D,1,16,11,5
93B,7/16/21,69.5,1,2,D,2,14,1,13
93B,7/16/21,34.75,1,2,D,3,10,2,8
93B,7/16/21,17.375,1,2,D,4,13,2,11
93B,7/16/21,8.6875,1,2,D,5,11,1,10
93B,7/16/21,4.34375,1,2,D,6,8,0,8
93B,7/16/21,2.171875,1,2,D,7,14,2,12
93B,7/16/21,1.0859375,1,2,D,8,13,2,11
93B,7/16/21,0.54296875,1,2,D,9,14,1,13
93B,7/16/21,0.271484375,1,2,D,10,13,1,12
VC,7/16/21,0,1,2,D,12,9,3,6
93C,7/16/21,130.5,1,2,E,1,8,1,7
93C,7/16/21,65.25,1,2,E,2,14,0,14
93C,7/16/21,32.625,1,2,E,3,11,0,11
93C,7/16/21,16.3125,1,2,E,4,14,1,13
93C,7/16/21,8.15625,1,2,E,5,17,4,13
93C,7/16/21,4.078125,1,2,E,6,14,5,9
93C,7/16/21,2.0390625,1,2,E,7,13,2,11
93C,7/16/21,1.01953125,1,2,E,8,12,0,12
93C,7/16/21,0.509765625,1,2,E,9,12,1,11
93C,7/16/21,0.254882813,1,2,E,10,10,4,6
VC,7/16/21,0,1,2,E,12,5,0,5
93D,7/16/21,135,1,2,F,1,10,2,8
93D,7/16/21,67.5,1,2,F,2,12,0,12
93D,7/16/21,33.75,1,2,F,3,14,6,8
93D,7/16/21,16.875,1,2,F,4,12,6,6
93D,7/16/21,8.4375,1,2,F,5,4,1,3
93D,7/16/21,4.21875,1,2,F,6,13,1,12
93D,7/16/21,2.109375,1,2,F,7,10,0,10
93D,7/16/21,1.0546875,1,2,F,8,9,4,5
93D,7/16/21,0.52734375,1,2,F,9,14,2,12
93D,7/16/21,0.263671875,1,2,F,10,11,1,10
VC,7/16/21,0,1,2,F,12,12,5,7
93E,7/16/21,140,1,2,G,1,13,4,9
93E,7/16/21,70,1,2,G,2,8,1,7
93E,7/16/21,35,1,2,G,3,12,1,11
93E,7/16/21,17.5,1,2,G,4,11,1,10
93E,7/16/21,8.75,1,2,G,5,13,4,9
93E,7/16/21,4.375,1,2,G,6,8,0,8
93E,7/16/21,2.1875,1,2,G,7,11,1,10
93E,7/16/21,1.09375,1,2,G,8,14,3,11
93E,7/16/21,0.546875,1,2,G,9,8,1,7
93E,7/16/21,0.2734375,1,2,G,10,15,1,14
VC,7/16/21,0,1,2,G,12,9,2,7
1036-14B,7/16/21,1.28,1,2,H,1,15,15,0
1036-14B,7/16/21,0.64,1,2,H,2,8,8,0
1036-14B,7/16/21,0.32,1,2,H,3,9,9,0
1036-14B,7/16/21,0.16,1,2,H,4,17,4,13
1036-14B,7/16/21,0.08,1,2,H,5,29,16,13
1036-14B,7/16/21,0.04,1,2,H,6,13,1,12
1036-14B,7/16/21,0.02,1,2,H,7,14,0,14
1036-14B,7/16/21,0.01,1,2,H,8,11,4,7
1036-14B,7/16/21,0.005,1,2,H,9,9,1,8
1036-14B,7/16/21,0.0025,1,2,H,10,13,3,10
VC,7/16/21,0,1,2,H,12,11,1,10
94A,7/16/21,124.5,1,3,A,1,7,2,5
94A,7/16/21,62.25,1,3,A,2,22,3,19
94A,7/16/21,31.125,1,3,A,3,8,0,8
94A,7/16/21,15.5625,1,3,A,4,10,2,8
94A,7/16/21,7.78125,1,3,A,5,5,1,4
94A,7/16/21,3.890625,1,3,A,6,8,3,5
94A,7/16/21,1.9453125,1,3,A,7,5,3,2
94A,7/16/21,0.97265625,1,3,A,8,6,2,4
94A,7/16/21,0.486328125,1,3,A,9,9,2,7
94A,7/16/21,0.243164063,1,3,A,10,12,2,10
VC,7/16/21,0,1,3,A,12,3,1,2
94B,7/16/21,135.5,1,3,B,1,19,11,8
94B,7/16/21,67.75,1,3,B,2,9,4,5
94B,7/16/21,33.875,1,3,B,3,14,4,10
94B,7/16/21,16.9375,1,3,B,4,6,4,2
94B,7/16/21,8.46875,1,3,B,5,11,4,7
94B,7/16/21,4.234375,1,3,B,6,3,1,2
94B,7/16/21,2.1171875,1,3,B,7,7,4,3
94B,7/16/21,1.05859375,1,3,B,8,9,3,6
94B,7/16/21,0.529296875,1,3,B,9,12,1,11
94B,7/16/21,0.264648438,1,3,B,10,15,4,11
VC,7/16/21,0,1,3,B,12,15,1,14
94C,7/16/21,128.5,1,3,C,1,11,4,7
94C,7/16/21,64.25,1,3,C,2,16,3,13
94C,7/16/21,32.125,1,3,C,3,16,4,12
94C,7/16/21,16.0625,1,3,C,4,16,1,15
94C,7/16/21,8.03125,1,3,C,5,13,3,10
94C,7/16/21,4.015625,1,3,C,6,12,6,6
94C,7/16/21,2.0078125,1,3,C,7,13,5,8
94C,7/16/21,1.00390625,1,3,C,8,10,0,10
94C,7/16/21,0.501953125,1,3,C,9,15,4,11
94C,7/16/21,0.250976563,1,3,C,10,11,2,9
VC,7/16/21,0,1,3,C,12,21,3,18
94D,7/16/21,128.5,1,3,D,1,12,5,7
94D,7/16/21,64.25,1,3,D,2,16,7,9
94D,7/16/21,32.125,1,3,D,3,13,1,12
94D,7/16/21,16.0625,1,3,D,4,13,0,13
94D,7/16/21,8.03125,1,3,D,5,17,4,13
94D,7/16/21,4.015625,1,3,D,6,9,2,7
94D,7/16/21,2.0078125,1,3,D,7,11,4,7
94D,7/16/21,1.00390625,1,3,D,8,15,3,12
94D,7/16/21,0.501953125,1,3,D,9,22,8,14
94D,7/16/21,0.250976563,1,3,D,10,16,5,11
VC,7/16/21,0,1,3,D,12,13,2,11
94E,7/16/21,132,1,3,E,1,10,0,10
94E,7/16/21,66,1,3,E,2,13,6,7
94E,7/16/21,33,1,3,E,3,8,2,6
94E,7/16/21,16.5,1,3,E,4,11,4,7
94E,7/16/21,8.25,1,3,E,5,11,1,10
94E,7/16/21,4.125,1,3,E,6,13,6,7
94E,7/16/21,2.0625,1,3,E,7,10,4,6
94E,7/16/21,1.03125,1,3,E,8,12,5,7
94E,7/16/21,0.515625,1,3,E,9,14,4,10
94E,7/16/21,0.2578125,1,3,E,10,9,2,7
VC,7/16/21,0,1,3,E,12,14,2,12
94F,7/16/21,147,1,3,F,1,13,2,11
94F,7/16/21,73.5,1,3,F,2,13,2,11
94F,7/16/21,36.75,1,3,F,3,10,0,10
94F,7/16/21,18.375,1,3,F,4,19,3,16
94F,7/16/21,9.1875,1,3,F,5,12,5,7
94F,7/16/21,4.59375,1,3,F,6,10,1,9
94F,7/16/21,2.296875,1,3,F,7,7,3,4
94F,7/16/21,1.1484375,1,3,F,8,12,3,9
94F,7/16/21,0.57421875,1,3,F,9,17,6,11
94F,7/16/21,0.287109375,1,3,F,10,13,3,10
VC,7/16/21,0,1,3,F,12,13,0,13
94G,7/16/21,64,1,3,G,1,8,1,7
94G,7/16/21,32,1,3,G,2,15,3,12
94G,7/16/21,16,1,3,G,3,8,2,6
94G,7/16/21,8,1,3,G,4,24,6,18
94G,7/16/21,4,1,3,G,5,13,6,7
94G,7/16/21,2,1,3,G,6,20,6,14
94G,7/16/21,1,1,3,G,7,2,1,1
94G,7/16/21,0.5,1,3,G,8,15,1,14
94G,7/16/21,0.25,1,3,G,9,8,1,7
94G,7/16/21,0.125,1,3,G,10,17,6,11
VC,7/16/21,0,1,3,G,12,16,2,14
1036-14B,7/16/21,1.28,1,3,H,1,9,9,0
1036-14B,7/16/21,0.64,1,3,H,2,8,8,0
1036-14B,7/16/21,0.32,1,3,H,3,13,8,5
1036-14B,7/16/21,0.16,1,3,H,4,10,3,7
1036-14B,7/16/21,0.08,1,3,H,5,16,5,11
1036-14B,7/16/21,0.04,1,3,H,6,13,4,9
1036-14B,7/16/21,0.02,1,3,H,7,11,4,7
1036-14B,7/16/21,0.01,1,3,H,8,12,1,11
1036-14B,7/16/21,0.005,1,3,H,9,13,8,5
1036-14B,7/16/21,0.0025,1,3,H,10,13,4,9
VC,7/16/21,0,1,3,H,12,18,5,13
38A,7/28/21,16,1,1,A,1,3,3,0
38A,7/28/21,8,1,1,A,2,2,2,0
38A,7/28/21,4,1,1,A,3,1,1,0
38A,7/28/21,2,1,1,A,4,2,1,1
38A,7/28/21,1,1,1,A,5,4,4,0
38A,7/28/21,0.5,1,1,A,6,8,7,1
38A,7/28/21,0.25,1,1,A,7,5,2,3
38A,7/28/21,0.125,1,1,A,8,11,7,4
38A,7/28/21,0.0625,1,1,A,9,7,3,4
38A,7/28/21,0.03125,1,1,A,10,13,7,6
VC,7/28/21,0,1,1,A,12,10,6,4
38F,7/28/21,8,1,1,B,1,9,7,2
38F,7/28/21,4,1,1,B,2,12,6,6
38F,7/28/21,2,1,1,B,3,6,3,3
38F,7/28/21,1,1,1,B,4,17,7,10
38F,7/28/21,0.5,1,1,B,5,12,1,11
38F,7/28/21,0.25,1,1,B,6,14,9,5
38F,7/28/21,0.125,1,1,B,7,6,3,3
38F,7/28/21,0.0625,1,1,B,8,13,6,7
38F,7/28/21,0.03125,1,1,B,9,8,1,7
38F,7/28/21,0.015625,1,1,B,10,10,3,7
VC,7/28/21,0,1,1,B,12,10,5,5
59C,7/28/21,8,1,1,C,1,6,2,4
59C,7/28/21,4,1,1,C,2,12,2,10
59C,7/28/21,2,1,1,C,3,5,2,3
59C,7/28/21,1,1,1,C,4,18,4,14
59C,7/28/21,0.5,1,1,C,5,12,3,9
59C,7/28/21,0.25,1,1,C,6,9,3,6
59C,7/28/21,0.125,1,1,C,7,7,2,5
59C,7/28/21,0.0625,1,1,C,8,9,3,6
59C,7/28/21,0.03125,1,1,C,9,8,4,4
59C,7/28/21,0.015625,1,1,C,10,11,7,4
VC,7/28/21,0,1,1,C,12,13,5,8
1036-14B,7/28/21,1.28,1,1,D,1,8,7,1
1036-14B,7/28/21,0.64,1,1,D,2,10,6,4
1036-14B,7/28/21,0.32,1,1,D,3,12,9,3
1036-14B,7/28/21,0.16,1,1,D,4,14,10,4
1036-14B,7/28/21,0.08,1,1,D,5,4,2,2
1036-14B,7/28/21,0.04,1,1,D,6,11,5,6
1036-14B,7/28/21,0.02,1,1,D,7,11,6,5
1036-14B,7/28/21,0.01,1,1,D,8,11,2,9
1036-14B,7/28/21,0.005,1,1,D,9,10,1,9
1036-14B,7/28/21,0.0025,1,1,D,10,9,3,6
VC,7/28/21,0,1,1,D,12,17,9,8
38N,7/29/21,1.28,1,1,A,1,10,9,1
38N,7/29/21,0.64,1,1,A,2,5,5,0
38N,7/29/21,0.32,1,1,A,3,15,14,1
38N,7/29/21,0.16,1,1,A,4,13,13,0
38N,7/29/21,0.08,1,1,A,5,1,1,0
38N,7/29/21,0.04,1,1,A,6,10,4,6
38N,7/29/21,0.02,1,1,A,7,6,0,6
38N,7/29/21,0.01,1,1,A,8,11,2,9
38N,7/29/21,0.005,1,1,A,9,14,1,13
38N,7/29/21,0.0025,1,1,A,10,13,3,10
VC,7/29/21,0,1,1,A,12,13,5,8
59G,7/29/21,16,1,1,B,1,7,5,2
59G,7/29/21,8,1,1,B,2,8,5,3
59G,7/29/21,4,1,1,B,3,18,11,7
59G,7/29/21,2,1,1,B,4,14,6,8
59G,7/29/21,1,1,1,B,5,18,5,13
59G,7/29/21,0.5,1,1,B,6,14,0,14
59G,7/29/21,0.25,1,1,B,7,6,1,5
59G,7/29/21,0.125,1,1,B,8,13,5,8
59G,7/29/21,0.0625,1,1,B,9,14,5,9
59G,7/29/21,0.03125,1,1,B,10,16,6,10
VC,7/29/21,0,1,1,B,12,12,3,9
35H,7/29/21,1.28,1,1,C,1,12,3,9
35H,7/29/21,0.64,1,1,C,2,16,6,10
35H,7/29/21,0.32,1,1,C,3,10,3,7
35H,7/29/21,0.16,1,1,C,4,7,4,3
35H,7/29/21,0.08,1,1,C,5,13,5,8
35H,7/29/21,0.04,1,1,C,6,12,6,6
35H,7/29/21,0.02,1,1,C,7,16,3,13
35H,7/29/21,0.01,1,1,C,8,15,7,8
35H,7/29/21,0.005,1,1,C,9,20,7,13
35H,7/29/21,0.0025,1,1,C,10,13,7,6
VC,7/29/21,0,1,1,C,12,14,4,10
38L,7/29/21,10.24,1,1,D,1,3,3,0
38L,7/29/21,5.12,1,1,D,2,9,9,0
38L,7/29/21,2.56,1,1,D,3,7,7,0
38L,7/29/21,1.28,1,1,D,4,11,11,0
38L,7/29/21,0.64,1,1,D,5,4,4,0
38L,7/29/21,0.32,1,1,D,6,9,9,0
38L,7/29/21,0.16,1,1,D,7,8,8,0
38L,7/29/21,0.08,1,1,D,8,8,8,0
38L,7/29/21,0.04,1,1,D,9,13,13,0
38L,7/29/21,0.02,1,1,D,10,12,12,0
VC,7/29/21,0,1,1,D,12,13,3,10
94M,7/29/21,64,1,1,E,1,13,7,6
94M,7/29/21,32,1,1,E,2,11,1,10
94M,7/29/21,16,1,1,E,3,11,6,5
94M,7/29/21,8,1,1,E,4,13,5,8
94M,7/29/21,4,1,1,E,5,11,3,8
94M,7/29/21,2,1,1,E,6,16,7,9
94M,7/29/21,1,1,1,E,7,6,0,6
94M,7/29/21,0.5,1,1,E,8,13,4,9
94M,7/29/21,0.25,1,1,E,9,15,2,13
94M,7/29/21,0.125,1,1,E,10,21,4,17
VC,7/29/21,0,1,1,E,12,22,2,20
93A,7/29/21,16,1,1,F,1,13,5,8
93A,7/29/21,8,1,1,F,2,12,9,3
93A,7/29/21,4,1,1,F,3,17,16,1
93A,7/29/21,2,1,1,F,4,9,2,7
93A,7/29/21,1,1,1,F,5,14,7,7
93A,7/29/21,0.5,1,1,F,6,11,4,7
93A,7/29/21,0.25,1,1,F,7,13,7,6
93A,7/29/21,0.125,1,1,F,8,11,4,7
93A,7/29/21,0.0625,1,1,F,9,10,3,7
93A,7/29/21,0.03125,1,1,F,10,6,3,3
VC,7/29/21,0,1,1,F,12,14,3,11
93B,7/29/21,139,1,1,G,1,11,2,9
93B,7/29/21,69.5,1,1,G,2,11,3,8
93B,7/29/21,34.75,1,1,G,3,14,7,7
93B,7/29/21,17.375,1,1,G,4,11,4,7
93B,7/29/21,8.6875,1,1,G,5,15,4,11
93B,7/29/21,4.34375,1,1,G,6,15,5,10
93B,7/29/21,2.171875,1,1,G,7,10,4,6
93B,7/29/21,1.0859375,1,1,G,8,13,8,5
93B,7/29/21,0.54296875,1,1,G,9,13,3,10
93B,7/29/21,0.271484375,1,1,G,10,7,1,6
VC,7/29/21,0,1,1,G,12,14,5,9
1036-14B,7/29/21,1.28,1,1,H,1,20,20,0
1036-14B,7/29/21,0.64,1,1,H,2,13,12,1
1036-14B,7/29/21,0.32,1,1,H,3,10,9,1
1036-14B,7/29/21,0.16,1,1,H,4,19,0,19
1036-14B,7/29/21,0.08,1,1,H,5,13,0,13
1036-14B,7/29/21,0.04,1,1,H,6,11,2,9
1036-14B,7/29/21,0.02,1,1,H,7,11,2,9
1036-14B,7/29/21,0.01,1,1,H,8,11,5,6
1036-14B,7/29/21,0.005,1,1,H,9,18,7,11
1036-14B,7/29/21,0.0025,1,1,H,10,12,2,10
VC,7/29/21,0,1,1,H,12,26,7,19
93C,7/29/21,130.5,1,2,A,1,6,1,5
93C,7/29/21,65.25,1,2,A,2,14,9,5
93C,7/29/21,32.625,1,2,A,3,14,9,5
93C,7/29/21,16.3125,1,2,A,4,14,5,9
93C,7/29/21,8.15625,1,2,A,5,12,7,5
93C,7/29/21,4.078125,1,2,A,6,11,4,7
93C,7/29/21,2.0390625,1,2,A,7,9,2,7
93C,7/29/21,1.01953125,1,2,A,8,6,3,3
93C,7/29/21,0.509765625,1,2,A,9,11,6,5
93C,7/29/21,0.254882813,1,2,A,10,11,2,9
VC,7/29/21,0,1,2,A,12,14,4,10
93D,7/29/21,135,1,2,B,1,10,6,4
93D,7/29/21,67.5,1,2,B,2,10,3,7
93D,7/29/21,33.75,1,2,B,3,16,11,5
93D,7/29/21,16.875,1,2,B,4,9,6,3
93D,7/29/21,8.4375,1,2,B,5,12,4,8
93D,7/29/21,4.21875,1,2,B,6,11,0,11
93D,7/29/21,2.109375,1,2,B,7,13,7,6
93D,7/29/21,1.0546875,1,2,B,8,7,3,4
93D,7/29/21,0.52734375,1,2,B,9,9,2,7
93D,7/29/21,0.263671875,1,2,B,10,12,12,0
VC,7/29/21,0,1,2,B,12,15,4,11
93E,7/29/21,140,1,2,C,1,14,2,12
93E,7/29/21,70,1,2,C,2,11,5,6
93E,7/29/21,35,1,2,C,3,12,8,4
93E,7/29/21,17.5,1,2,C,4,9,3,6
93E,7/29/21,8.75,1,2,C,5,19,14,5
93E,7/29/21,4.375,1,2,C,6,16,10,6
93E,7/29/21,2.1875,1,2,C,7,14,5,9
93E,7/29/21,1.09375,1,2,C,8,11,2,9
93E,7/29/21,0.546875,1,2,C,9,13,8,5
93E,7/29/21,0.2734375,1,2,C,10,15,5,10
VC,7/29/21,0,1,2,C,12,8,2,6
94A,7/29/21,124.5,1,2,D,1,12,8,4
94A,7/29/21,62.25,1,2,D,2,14,9,5
94A,7/29/21,31.125,1,2,D,3,17,6,11
94A,7/29/21,15.5625,1,2,D,4,13,2,11
94A,7/29/21,7.78125,1,2,D,5,7,4,3
94A,7/29/21,3.890625,1,2,D,6,12,4,8
94A,7/29/21,1.9453125,1,2,D,7,17,3,14
94A,7/29/21,0.97265625,1,2,D,8,16,4,12
94A,7/29/21,0.486328125,1,2,D,9,13,6,7
94A,7/29/21,0.243164063,1,2,D,10,17,5,12
VC,7/29/21,0,1,2,D,12,13,4,9
94B,7/29/21,135.5,1,2,E,1,12,4,8
94B,7/29/21,67.75,1,2,E,2,13,4,9
94B,7/29/21,33.875,1,2,E,3,19,8,11
94B,7/29/21,16.9375,1,2,E,4,18,9,9
94B,7/29/21,8.46875,1,2,E,5,7,4,3
94B,7/29/21,4.234375,1,2,E,6,16,4,12
94B,7/29/21,2.1171875,1,2,E,7,13,3,10
94B,7/29/21,1.05859375,1,2,E,8,12,3,9
94B,7/29/21,0.529296875,1,2,E,9,25,7,18
94B,7/29/21,0.264648438,1,2,E,10,12,2,10
VC,7/29/21,0,1,2,E,12,11,2,9
94C,7/29/21,128.5,1,2,F,1,15,6,9
94C,7/29/21,64.25,1,2,F,2,12,4,8
94C,7/29/21,32.125,1,2,F,3,11,2,9
94C,7/29/21,16.0625,1,2,F,4,12,3,9
94C,7/29/21,8.03125,1,2,F,5,7,0,7
94C,7/29/21,4.015625,1,2,F,6,11,2,9
94C,7/29/21,2.0078125,1,2,F,7,16,4,12
94C,7/29/21,1.00390625,1,2,F,8,13,4,9
94C,7/29/21,0.501953125,1,2,F,9,8,0,8
94C,7/29/21,0.250976563,1,2,F,10,12,3,9
VC,7/29/21,0,1,2,F,12,9,4,5
94D,7/29/21,128.5,1,2,G,1,9,5,4
94D,7/29/21,64.25,1,2,G,2,11,5,6
94D,7/29/21,32.125,1,2,G,3,8,4,4
94D,7/29/21,16.0625,1,2,G,4,12,3,9
94D,7/29/21,8.03125,1,2,G,5,4,1,3
94D,7/29/21,4.015625,1,2,G,6,8,4,4
94D,7/29/21,2.0078125,1,2,G,7,11,3,8
94D,7/29/21,1.00390625,1,2,G,8,15,4,11
94D,7/29/21,0.501953125,1,2,G,9,10,4,6
94D,7/29/21,0.250976563,1,2,G,10,12,4,8
VC,7/29/21,0,1,2,G,12,3,0,3
1036-14B,7/29/21,1.28,1,2,H,1,16,16,0
1036-14B,7/29/21,0.64,1,2,H,2,4,4,0
1036-14B,7/29/21,0.32,1,2,H,3,9,7,2
1036-14B,7/29/21,0.16,1,2,H,4,7,4,3
1036-14B,7/29/21,0.08,1,2,H,5,13,6,7
1036-14B,7/29/21,0.04,1,2,H,6,11,4,7
1036-14B,7/29/21,0.02,1,2,H,7,10,4,6
1036-14B,7/29/21,0.01,1,2,H,8,11,7,4
1036-14B,7/29/21,0.005,1,2,H,9,8,3,5
1036-14B,7/29/21,0.0025,1,2,H,10,15,4,11
VC,7/29/21,0,1,2,H,12,7,2,5
94E,7/29/21,132,1,3,A,1,13,7,6
94E,7/29/21,66,1,3,A,2,8,2,6
94E,7/29/21,33,1,3,A,3,11,2,9
94E,7/29/21,16.5,1,3,A,4,9,4,5
94E,7/29/21,8.25,1,3,A,5,10,3,7
94E,7/29/21,4.125,1,3,A,6,12,6,6
94E,7/29/21,2.0625,1,3,A,7,13,4,9
94E,7/29/21,1.03125,1,3,A,8,11,4,7
94E,7/29/21,0.515625,1,3,A,9,16,5,11
94E,7/29/21,0.2578125,1,3,A,10,12,5,7
VC,7/29/21,0,1,3,A,12,18,1,17
94F,7/29/21,147,1,3,B,1,11,4,7
94F,7/29/21,73.5,1,3,B,2,14,6,8
94F,7/29/21,36.75,1,3,B,3,14,3,11
94F,7/29/21,18.375,1,3,B,4,5,1,4
94F,7/29/21,9.1875,1,3,B,5,8,2,6
94F,7/29/21,4.59375,1,3,B,6,15,7,8
94F,7/29/21,2.296875,1,3,B,7,10,2,8
94F,7/29/21,1.1484375,1,3,B,8,14,5,9
94F,7/29/21,0.57421875,1,3,B,9,9,3,6
94F,7/29/21,0.287109375,1,3,B,10,7,4,3
VC,7/29/21,0,1,3,B,12,12,2,10
94G,7/29/21,64,1,3,C,1,11,0,11
94G,7/29/21,32,1,3,C,2,12,3,9
94G,7/29/21,16,1,3,C,3,10,5,5
94G,7/29/21,8,1,3,C,4,7,0,7
94G,7/29/21,4,1,3,C,5,12,4,8
94G,7/29/21,2,1,3,C,6,10,2,8
94G,7/29/21,1,1,3,C,7,12,3,9
94G,7/29/21,0.5,1,3,C,8,9,4,5
94G,7/29/21,0.25,1,3,C,9,22,9,13
94G,7/29/21,0.125,1,3,C,10,10,4,6
VC,7/29/21,0,1,3,C,12,10,3,7
94H,7/29/21,134,1,3,D,1,17,5,12
94H,7/29/21,67,1,3,D,2,9,4,5
94H,7/29/21,33.5,1,3,D,3,12,3,9
94H,7/29/21,16.75,1,3,D,4,13,2,11
94H,7/29/21,8.375,1,3,D,5,11,5,6
94H,7/29/21,4.1875,1,3,D,6,11,3,8
94H,7/29/21,2.09375,1,3,D,7,11,3,8
94H,7/29/21,1.046875,1,3,D,8,21,10,11
94H,7/29/21,0.5234375,1,3,D,9,10,8,2
94H,7/29/21,0.26171875,1,3,D,10,10,4,6
VC,7/29/21,0,1,3,D,12,8,3,5
94I,7/29/21,81.75,1,3,E,1,19,7,12
94I,7/29/21,40.875,1,3,E,2,15,8,7
94I,7/29/21,20.4375,1,3,E,3,10,4,6
94I,7/29/21,10.21875,1,3,E,4,8,3,5
94I,7/29/21,5.109375,1,3,E,5,14,8,6
94I,7/29/21,2.5546875,1,3,E,6,10,4,6
94I,7/29/21,1.27734375,1,3,E,7,8,1,7
94I,7/29/21,0.638671875,1,3,E,8,14,6,8
94I,7/29/21,0.319335938,1,3,E,9,22,3,19
94I,7/29/21,0.159667969,1,3,E,10,14,2,12
VC,7/29/21,0,1,3,E,12,9,0,9
94J,7/29/21,70.25,1,3,F,1,0,,
94J,7/29/21,35.125,1,3,F,2,0,,
94J,7/29/21,17.5625,1,3,F,3,0,,
94J,7/29/21,8.78125,1,3,F,4,0,,
94J,7/29/21,4.390625,1,3,F,5,0,,
94J,7/29/21,2.1953125,1,3,F,6,0,,
94J,7/29/21,1.09765625,1,3,F,7,0,,
94J,7/29/21,0.548828125,1,3,F,8,16,6,10
94J,7/29/21,0.274414063,1,3,F,9,14,4,10
94J,7/29/21,0.137207031,1,3,F,10,15,2,13
VC,7/29/21,0,1,3,F,12,9,5,4
94L,7/29/21,64.75,1,3,G,1,0,,
94L,7/29/21,32.375,1,3,G,2,0,,
94L,7/29/21,16.1875,1,3,G,3,0,,
94L,7/29/21,8.09375,1,3,G,4,0,,
94L,7/29/21,4.046875,1,3,G,5,0,,
94L,7/29/21,2.0234375,1,3,G,6,0,,
94L,7/29/21,1.01171875,1,3,G,7,0,,
94L,7/29/21,0.505859375,1,3,G,8,0,,
94L,7/29/21,0.252929688,1,3,G,9,0,,
94L,7/29/21,0.126464844,1,3,G,10,0,,
VC,7/29/21,0,1,3,G,12,0,,
1036-14B,7/29/21,1.28,1,3,H,1,0,,
1036-14B,7/29/21,0.64,1,3,H,2,0,,
1036-14B,7/29/21,0.32,1,3,H,3,0,,
1036-14B,7/29/21,0.16,1,3,H,4,0,,
1036-14B,7/29/21,0.08,1,3,H,5,0,,
1036-14B,7/29/21,0.04,1,3,H,6,0,,
1036-14B,7/29/21,0.02,1,3,H,7,0,,
1036-14B,7/29/21,0.01,1,3,H,8,0,,
1036-14B,7/29/21,0.005,1,3,H,9,0,,
1036-14B,7/29/21,0.0025,1,3,H,10,0,,
VC,7/29/21,0,1,3,H,12,0,,
35L,7/30/21,1.28,1,1,A,1,7,1,6
35L,7/30/21,0.64,1,1,A,2,12,3,9
35L,7/30/21,0.32,1,1,A,3,10,1,9
35L,7/30/21,0.16,1,1,A,4,14,3,11
35L,7/30/21,0.08,1,1,A,5,9,2,7
35L,7/30/21,0.04,1,1,A,6,8,2,6
35L,7/30/21,0.02,1,1,A,7,10,3,7
35L,7/30/21,0.01,1,1,A,8,3,1,2
35L,7/30/21,0.005,1,1,A,9,3,0,3
35L,7/30/21,0.0025,1,1,A,10,10,2,8
VC,7/30/21,0,1,1,A,12,9,3,6
94A,7/30/21,124.5,1,1,B,1,9,2,7
94A,7/30/21,62.25,1,1,B,2,9,2,7
94A,7/30/21,31.125,1,1,B,3,9,1,8
94A,7/30/21,15.5625,1,1,B,4,9,2,7
94A,7/30/21,7.78125,1,1,B,5,9,2,7
94A,7/30/21,3.890625,1,1,B,6,8,1,7
94A,7/30/21,1.9453125,1,1,B,7,6,0,6
94A,7/30/21,0.97265625,1,1,B,8,9,2,7
94A,7/30/21,0.486328125,1,1,B,9,10,2,8
94A,7/30/21,0.243164063,1,1,B,10,4,2,2
VC,7/30/21,0,1,1,B,12,9,1,8
94B,7/30/21,135.5,1,1,C,1,5,2,3
94B,7/30/21,67.75,1,1,C,2,10,2,8
94B,7/30/21,33.875,1,1,C,3,9,3,6
94B,7/30/21,16.9375,1,1,C,4,7,3,4
94B,7/30/21,8.46875,1,1,C,5,6,1,5
94B,7/30/21,4.234375,1,1,C,6,11,5,6
94B,7/30/21,2.1171875,1,1,C,7,12,0,12
94B,7/30/21,1.05859375,1,1,C,8,5,1,4
94B,7/30/21,0.529296875,1,1,C,9,7,1,6
94B,7/30/21,0.264648438,1,1,C,10,6,1,5
VC,7/30/21,0,1,1,C,12,4,1,3
94C,7/30/21,128.5,1,1,D,1,9,9,0
94C,7/30/21,64.25,1,1,D,2,9,2,7
94C,7/30/21,32.125,1,1,D,3,8,3,5
94C,7/30/21,16.0625,1,1,D,4,9,3,6
94C,7/30/21,8.03125,1,1,D,5,14,5,9
94C,7/30/21,4.015625,1,1,D,6,6,1,5
94C,7/30/21,2.0078125,1,1,D,7,7,1,6
94C,7/30/21,1.00390625,1,1,D,8,8,0,8
94C,7/30/21,0.501953125,1,1,D,9,8,1,7
94C,7/30/21,0.250976563,1,1,D,10,6,2,4
VC,7/30/21,0,1,1,D,12,13,4,9
94D,7/30/21,128.5,1,1,E,1,3,2,1
94D,7/30/21,64.25,1,1,E,2,6,3,3
94D,7/30/21,32.125,1,1,E,3,8,6,2
94D,7/30/21,16.0625,1,1,E,4,7,1,6
94D,7/30/21,8.03125,1,1,E,5,2,1,1
94D,7/30/21,4.015625,1,1,E,6,10,1,9
94D,7/30/21,2.0078125,1,1,E,7,6,3,3
94D,7/30/21,1.00390625,1,1,E,8,10,5,5
94D,7/30/21,0.501953125,1,1,E,9,5,1,4
94D,7/30/21,0.250976563,1,1,E,10,6,2,4
VC,7/30/21,0,1,1,E,12,4,2,2
94E,7/30/21,132,1,1,F,1,6,0,6
94E,7/30/21,66,1,1,F,2,5,1,4
94E,7/30/21,33,1,1,F,3,11,4,7
94E,7/30/21,16.5,1,1,F,4,4,0,4
94E,7/30/21,8.25,1,1,F,5,10,1,9
94E,7/30/21,4.125,1,1,F,6,3,0,3
94E,7/30/21,2.0625,1,1,F,7,7,3,4
94E,7/30/21,1.03125,1,1,F,8,5,0,5
94E,7/30/21,0.515625,1,1,F,9,5,0,5
94E,7/30/21,0.2578125,1,1,F,10,3,1,2
VC,7/30/21,0,1,1,F,12,11,3,8
94F,7/30/21,147,1,1,G,1,12,0,12
94F,7/30/21,73.5,1,1,G,2,13,8,5
94F,7/30/21,36.75,1,1,G,3,5,2,3
94F,7/30/21,18.375,1,1,G,4,6,3,3
94F,7/30/21,9.1875,1,1,G,5,7,2,5
94F,7/30/21,4.59375,1,1,G,6,8,2,6
94F,7/30/21,2.296875,1,1,G,7,5,1,4
94F,7/30/21,1.1484375,1,1,G,8,4,2,2
94F,7/30/21,0.57421875,1,1,G,9,8,3,5
94F,7/30/21,0.287109375,1,1,G,10,8,2,6
VC,7/30/21,0,1,1,G,12,13,3,10
1036-14B,7/30/21,1.28,1,1,H,1,12,12,0
1036-14B,7/30/21,0.64,1,1,H,2,5,5,0
1036-14B,7/30/21,0.32,1,1,H,3,5,3,2
1036-14B,7/30/21,0.16,1,1,H,4,13,4,9
1036-14B,7/30/21,0.08,1,1,H,5,7,1,6
1036-14B,7/30/21,0.04,1,1,H,6,12,3,9
1036-14B,7/30/21,0.02,1,1,H,7,6,0,6
1036-14B,7/30/21,0.01,1,1,H,8,16,8,8
1036-14B,7/30/21,0.005,1,1,H,9,8,3,5
1036-14B,7/30/21,0.0025,1,1,H,10,11,2,9
VC,7/30/21,0,1,1,H,12,14,3,11
94G,7/30/21,64,1,2,A,1,6,2,4
94G,7/30/21,32,1,2,A,2,9,2,7
94G,7/30/21,16,1,2,A,3,2,0,2
94G,7/30/21,8,1,2,A,4,5,2,3
94G,7/30/21,4,1,2,A,5,2,0,2
94G,7/30/21,2,1,2,A,6,6,0,6
94G,7/30/21,1,1,2,A,7,6,0,6
94G,7/30/21,0.5,1,2,A,8,8,2,6
94G,7/30/21,0.25,1,2,A,9,8,2,6
94G,7/30/21,0.125,1,2,A,10,11,4,7
VC,7/30/21,0,1,2,A,12,12,3,9
94H,7/30/21,134,1,2,B,1,9,5,4
94H,7/30/21,67,1,2,B,2,10,2,8
94H,7/30/21,33.5,1,2,B,3,8,2,6
94H,7/30/21,16.75,1,2,B,4,3,0,3
94H,7/30/21,8.375,1,2,B,5,6,2,4
94H,7/30/21,4.1875,1,2,B,6,9,1,8
94H,7/30/21,2.09375,1,2,B,7,14,4,10
94H,7/30/21,1.046875,1,2,B,8,6,1,5
94H,7/30/21,0.5234375,1,2,B,9,6,0,6
94H,7/30/21,0.26171875,1,2,B,10,7,0,7
VC,7/30/21,0,1,2,B,12,10,3,7
94I,7/30/21,81.75,1,2,C,1,10,3,7
94I,7/30/21,40.875,1,2,C,2,9,4,5
94I,7/30/21,20.4375,1,2,C,3,5,2,3
94I,7/30/21,10.21875,1,2,C,4,10,2,8
94I,7/30/21,5.109375,1,2,C,5,7,4,3
94I,7/30/21,2.5546875,1,2,C,6,5,3,2
94I,7/30/21,1.27734375,1,2,C,7,11,5,6
94I,7/30/21,0.638671875,1,2,C,8,7,1,6
94I,7/30/21,0.319335938,1,2,C,9,9,3,6
94I,7/30/21,0.159667969,1,2,C,10,8,0,8
VC,7/30/21,0,1,2,C,12,8,3,5
94J,7/30/21,70.25,1,2,D,1,11,3,8
94J,7/30/21,35.125,1,2,D,2,6,0,6
94J,7/30/21,17.5625,1,2,D,3,18,8,10
94J,7/30/21,8.78125,1,2,D,4,11,5,6
94J,7/30/21,4.390625,1,2,D,5,14,2,12
94J,7/30/21,2.1953125,1,2,D,6,8,2,6
94J,7/30/21,1.09765625,1,2,D,7,12,3,9
94J,7/30/21,0.548828125,1,2,D,8,8,0,8
94J,7/30/21,0.274414063,1,2,D,9,11,1,10
94J,7/30/21,0.137207031,1,2,D,10,12,3,9
VC,7/30/21,0,1,2,D,12,12,2,10
94L,7/30/21,64.75,1,2,E,1,6,0,6
94L,7/30/21,32.375,1,2,E,2,12,6,6
94L,7/30/21,16.1875,1,2,E,3,13,7,6
94L,7/30/21,8.09375,1,2,E,4,11,5,6
94L,7/30/21,4.046875,1,2,E,5,9,3,6
94L,7/30/21,2.0234375,1,2,E,6,6,2,4
94L,7/30/21,1.01171875,1,2,E,7,9,4,5
94L,7/30/21,0.505859375,1,2,E,8,14,6,8
94L,7/30/21,0.252929688,1,2,E,9,12,2,10
94L,7/30/21,0.126464844,1,2,E,10,13,1,12
VC,7/30/21,0,1,2,E,12,12,3,9
94M,7/30/21,64,1,2,F,1,21,11,10
94M,7/30/21,32,1,2,F,2,16,11,5
94M,7/30/21,16,1,2,F,3,15,6,9
94M,7/30/21,8,1,2,F,4,18,7,11
94M,7/30/21,4,1,2,F,5,2,1,1
94M,7/30/21,2,1,2,F,6,7,1,6
94M,7/30/21,1,1,2,F,7,11,1,10
94M,7/30/21,0.5,1,2,F,8,11,1,10
94M,7/30/21,0.25,1,2,F,9,12,4,8
94M,7/30/21,0.125,1,2,F,10,16,3,13
VC,7/30/21,0,1,2,F,12,6,1,5
35H,7/30/21,1.28,1,2,G,1,6,3,3
35H,7/30/21,0.64,1,2,G,2,7,5,2
35H,7/30/21,0.32,1,2,G,3,6,5,1
35H,7/30/21,0.16,1,2,G,4,10,0,10
35H,7/30/21,0.08,1,2,G,5,18,1,17
35H,7/30/21,0.04,1,2,G,6,12,3,9
35H,7/30/21,0.02,1,2,G,7,9,2,7
35H,7/30/21,0.01,1,2,G,8,15,7,8
35H,7/30/21,0.005,1,2,G,9,12,1,11
35H,7/30/21,0.0025,1,2,G,10,11,4,7
VC,7/30/21,0,1,2,G,12,6,0,6
1036-14B,7/30/21,1.28,1,2,H,1,12,12,0
1036-14B,7/30/21,0.64,1,2,H,2,4,4,0
1036-14B,7/30/21,0.32,1,2,H,3,13,7,6
1036-14B,7/30/21,0.16,1,2,H,4,15,0,15
1036-14B,7/30/21,0.08,1,2,H,5,7,1,6
1036-14B,7/30/21,0.04,1,2,H,6,8,1,7
1036-14B,7/30/21,0.02,1,2,H,7,13,2,11
1036-14B,7/30/21,0.01,1,2,H,8,18,7,11
1036-14B,7/30/21,0.005,1,2,H,9,29,2,27
1036-14B,7/30/21,0.0025,1,2,H,10,50,2,48
VC,7/30/21,0,1,2,H,12,15,7,8
38A,8/4/21,16,1,1,A,1,9,9,0
38A,8/4/21,8,1,1,A,2,8,8,0
38A,8/4/21,4,1,1,A,3,9,9,0
38A,8/4/21,2,1,1,A,4,11,11,0
38A,8/4/21,1,1,1,A,5,9,8,1
38A,8/4/21,0.5,1,1,A,6,6,6,0
38A,8/4/21,0.25,1,1,A,7,8,8,0
38A,8/4/21,0.125,1,1,A,8,1,6,1
38A,8/4/21,0.0625,1,1,A,9,4,3,4
38A,8/4/21,0.03125,1,1,A,10,5,2,5
VC,8/4/21,0,1,1,A,12,9,1,9
57D,8/4/21,4,1,1,B,1,8,8,0
57D,8/4/21,2,1,1,B,2,9,9,0
57D,8/4/21,1,1,1,B,3,13,13,0
57D,8/4/21,0.5,1,1,B,4,11,9,2
57D,8/4/21,0.25,1,1,B,5,7,4,3
57D,8/4/21,0.125,1,1,B,6,8,4,4
57D,8/4/21,0.0625,1,1,B,7,9,2,7
57D,8/4/21,0.03125,1,1,B,8,11,2,9
57D,8/4/21,0.015625,1,1,B,9,9,0,9
57D,8/4/21,0.0078125,1,1,B,10,8,2,6
VC,8/4/21,0,1,1,B,12,9,1,8
57E,8/4/21,32,1,1,C,1,9,9,0
57E,8/4/21,16,1,1,C,2,5,5,0
57E,8/4/21,8,1,1,C,3,7,7,0
57E,8/4/21,4,1,1,C,4,9,9,0
57E,8/4/21,2,1,1,C,5,10,9,1
57E,8/4/21,1,1,1,C,6,10,10,0
57E,8/4/21,0.5,1,1,C,7,10,10,0
57E,8/4/21,0.25,1,1,C,8,9,4,5
57E,8/4/21,0.125,1,1,C,9,9,1,8
57E,8/4/21,0.0625,1,1,C,10,11,0,11
VC,8/4/21,0,1,1,C,12,8,5,3
57G,8/4/21,2,1,1,D,1,4,4,0
57G,8/4/21,1,1,1,D,2,5,4,1
57G,8/4/21,0.5,1,1,D,3,7,7,0
57G,8/4/21,0.25,1,1,D,4,7,2,5
57G,8/4/21,0.125,1,1,D,5,9,3,6
57G,8/4/21,0.0625,1,1,D,6,9,1,8
57G,8/4/21,0.03125,1,1,D,7,8,4,4
57G,8/4/21,0.015625,1,1,D,8,8,0,8
57G,8/4/21,0.0078125,1,1,D,9,10,3,7
57G,8/4/21,0.00390625,1,1,D,10,9,1,8
VC,8/4/21,0,1,1,D,12,9,1,8
34A,8/4/21,16,1,1,E,1,7,7,0
34A,8/4/21,8,1,1,E,2,8,8,0
34A,8/4/21,4,1,1,E,3,8,7,1
34A,8/4/21,2,1,1,E,4,8,7,1
34A,8/4/21,1,1,1,E,5,8,7,1
34A,8/4/21,0.5,1,1,E,6,8,8,0
34A,8/4/21,0.25,1,1,E,7,7,7,0
34A,8/4/21,0.125,1,1,E,8,11,5,6
34A,8/4/21,0.0625,1,1,E,9,12,6,6
34A,8/4/21,0.03125,1,1,E,10,5,2,3
VC,8/4/21,0,1,1,E,12,10,3,7
57D,8/4/21,4,1,1,F,1,5,5,0
57D,8/4/21,2,1,1,F,2,9,9,0
57D,8/4/21,1,1,1,F,3,10,10,0
57D,8/4/21,0.5,1,1,F,4,6,4,2
57D,8/4/21,0.25,1,1,F,5,11,6,5
57D,8/4/21,0.125,1,1,F,6,13,3,10
57D,8/4/21,0.0625,1,1,F,7,7,1,6
57D,8/4/21,0.03125,1,1,F,8,6,1,5
57D,8/4/21,0.015625,1,1,F,9,6,1,5
57D,8/4/21,0.0078125,1,1,F,10,6,0,6
VC,8/4/21,0,1,1,F,12,8,5,3
57E,8/4/21,32,1,1,G,1,3,3,0
57E,8/4/21,16,1,1,G,2,12,12,0
57E,8/4/21,8,1,1,G,3,13,13,0
57E,8/4/21,4,1,1,G,4,8,8,0
57E,8/4/21,2,1,1,G,5,5,5,0
57E,8/4/21,1,1,1,G,6,2,2,0
57E,8/4/21,0.5,1,1,G,7,10,10,0
57E,8/4/21,0.25,1,1,G,8,9,8,1
57E,8/4/21,0.125,1,1,G,9,9,3,6
57E,8/4/21,0.0625,1,1,G,10,6,3,3
VC,8/4/21,0,1,1,G,12,9,2,7
57G,8/4/21,2,1,1,H,1,2,2,0
57G,8/4/21,1,1,1,H,2,6,6,0
57G,8/4/21,0.5,1,1,H,3,10,10,0
57G,8/4/21,0.25,1,1,H,4,6,3,3
57G,8/4/21,0.125,1,1,H,5,9,4,5
57G,8/4/21,0.0625,1,1,H,6,11,4,7
57G,8/4/21,0.03125,1,1,H,7,8,5,3
57G,8/4/21,0.015625,1,1,H,8,6,1,5
57G,8/4/21,0.0078125,1,1,H,9,9,4,5
57G,8/4/21,0.00390625,1,1,H,10,13,7,6
VC,8/4/21,0,1,1,H,12,9,2,7
38A,8/5/21,16,1,1,A,1,11,11,0
38A,8/5/21,8,1,1,A,2,6,6,0
38A,8/5/21,4,1,1,A,3,6,6,0
38A,8/5/21,2,1,1,A,4,8,8,0
38A,8/5/21,1,1,1,A,5,3,3,0
38A,8/5/21,0.5,1,1,A,6,7,7,0
38A,8/5/21,0.25,1,1,A,7,6,5,1
38A,8/5/21,0.125,1,1,A,8,13,11,2
38A,8/5/21,0.0625,1,1,A,9,8,5,3
38A,8/5/21,0.03125,1,1,A,10,7,1,6
VC,8/5/21,0,1,1,A,12,6,2,4
57D,8/5/21,4,1,1,B,1,7,7,0
57D,8/5/21,2,1,1,B,2,4,4,0
57D,8/5/21,1,1,1,B,3,5,5,0
57D,8/5/21,0.5,1,1,B,4,8,6,2
57D,8/5/21,0.25,1,1,B,5,9,4,5
57D,8/5/21,0.125,1,1,B,6,12,7,5
57D,8/5/21,0.0625,1,1,B,7,4,0,4
57D,8/5/21,0.03125,1,1,B,8,8,2,6
57D,8/5/21,0.015625,1,1,B,9,10,8,2
57D,8/5/21,0.0078125,1,1,B,10,7,4,3
VC,8/5/21,0,1,1,B,12,7,2,5
57E,8/5/21,32,1,1,C,1,14,14,0
57E,8/5/21,16,1,1,C,2,9,9,0
57E,8/5/21,8,1,1,C,3,4,4,0
57E,8/5/21,4,1,1,C,4,8,7,1
57E,8/5/21,2,1,1,C,5,6,6,0
57E,8/5/21,1,1,1,C,6,14,14,0
57E,8/5/21,0.5,1,1,C,7,6,6,0
57E,8/5/21,0.25,1,1,C,8,7,6,1
57E,8/5/21,0.125,1,1,C,9,8,2,6
57E,8/5/21,0.0625,1,1,C,10,5,0,5
VC,8/5/21,0,1,1,C,12,6,1,5
57G,8/5/21,2,1,1,D,1,4,4,0
57G,8/5/21,1,1,1,D,2,6,6,0
57G,8/5/21,0.5,1,1,D,3,6,6,0
57G,8/5/21,0.25,1,1,D,4,3,1,2
57G,8/5/21,0.125,1,1,D,5,9,4,5
57G,8/5/21,0.0625,1,1,D,6,7,2,5
57G,8/5/21,0.03125,1,1,D,7,9,4,5
57G,8/5/21,0.015625,1,1,D,8,9,3,6
57G,8/5/21,0.0078125,1,1,D,9,10,3,7
57G,8/5/21,0.00390625,1,1,D,10,5,2,3
VC,8/5/21,0,1,1,D,12,13,5,8
59C,8/5/21,8,1,1,E,1,11,4,7
59C,8/5/21,4,1,1,E,2,6,0,6
59C,8/5/21,2,1,1,E,3,5,2,3
59C,8/5/21,1,1,1,E,4,2,1,1
59C,8/5/21,0.5,1,1,E,5,6,4,2
59C,8/5/21,0.25,1,1,E,6,8,2,6
59C,8/5/21,0.125,1,1,E,7,8,3,5
59C,8/5/21,0.0625,1,1,E,8,4,1,3
59C,8/5/21,0.03125,1,1,E,9,7,1,6
59C,8/5/21,0.015625,1,1,E,10,5,3,2
VC,8/5/21,0,1,1,E,12,3,1,2
59G,8/5/21,16,1,1,F,1,5,2,3
59G,8/5/21,8,1,1,F,2,1,1,0
59G,8/5/21,4,1,1,F,3,5,1,4
59G,8/5/21,2,1,1,F,4,5,4,1
59G,8/5/21,1,1,1,F,5,1,1,0
59G,8/5/21,0.5,1,1,F,6,4,2,2
59G,8/5/21,0.25,1,1,F,7,2,2,0
59G,8/5/21,0.125,1,1,F,8,9,5,4
59G,8/5/21,0.0625,1,1,F,9,6,0,6
59G,8/5/21,0.03125,1,1,F,10,11,7,4
VC,8/5/21,0,1,1,F,12,15,8,7
59E,8/5/21,8,1,1,G,1,3,3,0
59E,8/5/21,4,1,1,G,2,3,2,1
59E,8/5/21,2,1,1,G,3,5,4,1
59E,8/5/21,1,1,1,G,4,8,8,0
59E,8/5/21,0.5,1,1,G,5,3,2,1
59E,8/5/21,0.25,1,1,G,6,3,3,0
59E,8/5/21,0.125,1,1,G,7,4,3,1
59E,8/5/21,0.0625,1,1,G,8,6,3,3
59E,8/5/21,0.03125,1,1,G,9,8,3,5
59E,8/5/21,0.015625,1,1,G,10,5,5,0
VC,8/5/21,0,1,1,G,12,7,5,2
38F,8/5/21,8,1,1,H,1,5,5,0
38F,8/5/21,4,1,1,H,2,6,5,1
38F,8/5/21,2,1,1,H,3,2,1,1
38F,8/5/21,1,1,1,H,4,3,2,1
38F,8/5/21,0.5,1,1,H,5,7,6,1
38F,8/5/21,0.25,1,1,H,6,5,3,2
38F,8/5/21,0.125,1,1,H,7,4,2,2
38F,8/5/21,0.0625,1,1,H,8,3,1,2
38F,8/5/21,0.03125,1,1,H,9,4,2,2
38F,8/5/21,0.015625,1,1,H,10,5,3,2
VC,8/5/21,0,1,1,H,12,9,6,3
38A,8/6/21,16,1,1,A,1,6,6,0
38A,8/6/21,8,1,1,A,2,10,10,0
38A,8/6/21,4,1,1,A,3,9,9,0
38A,8/6/21,2,1,1,A,4,16,12,4
38A,8/6/21,1,1,1,A,5,12,10,2
38A,8/6/21,0.5,1,1,A,6,7,5,2
38A,8/6/21,0.25,1,1,A,7,11,7,4
38A,8/6/21,0.125,1,1,A,8,5,3,2
38A,8/6/21,0.0625,1,1,A,9,12,4,8
38A,8/6/21,0.03125,1,1,A,10,13,5,8
VC,8/6/21,0,1,1,A,12,14,6,8
57D,8/6/21,4,1,1,B,1,8,8,0
57D,8/6/21,2,1,1,B,2,8,8,0
57D,8/6/21,1,1,1,B,3,11,11,0
57D,8/6/21,0.5,1,1,B,4,10,8,2
57D,8/6/21,0.25,1,1,B,5,16,4,12
57D,8/6/21,0.125,1,1,B,6,9,6,3
57D,8/6/21,0.0625,1,1,B,7,10,6,4
57D,8/6/21,0.03125,1,1,B,8,7,2,5
57D,8/6/21,0.015625,1,1,B,9,17,9,8
57D,8/6/21,0.0078125,1,1,B,10,13,5,8
VC,8/6/21,0,1,1,B,12,6,1,5
57E,8/6/21,32,1,1,C,1,6,6,0
57E,8/6/21,16,1,1,C,2,9,9,0
57E,8/6/21,8,1,1,C,3,6,6,0
57E,8/6/21,4,1,1,C,4,6,6,0
57E,8/6/21,2,1,1,C,5,9,9,0
57E,8/6/21,1,1,1,C,6,11,11,0
57E,8/6/21,0.5,1,1,C,7,13,11,2
57E,8/6/21,0.25,1,1,C,8,8,1,7
57E,8/6/21,0.125,1,1,C,9,9,1,8
57E,8/6/21,0.0625,1,1,C,10,15,4,11
VC,8/6/21,0,1,1,C,12,7,4,3
57G,8/6/21,2,1,1,D,1,6,6,0
57G,8/6/21,1,1,1,D,2,8,8,0
57G,8/6/21,0.5,1,1,D,3,6,5,1
57G,8/6/21,0.25,1,1,D,4,6,1,5
57G,8/6/21,0.125,1,1,D,5,13,5,8
57G,8/6/21,0.0625,1,1,D,6,9,4,5
57G,8/6/21,0.03125,1,1,D,7,7,2,5
57G,8/6/21,0.015625,1,1,D,8,6,5,1
57G,8/6/21,0.0078125,1,1,D,9,10,6,4
57G,8/6/21,0.00390625,1,1,D,10,14,4,10
VC,8/6/21,0,1,1,D,12,9,2,7
59C,8/6/21,8,1,1,E,1,8,3,5
59C,8/6/21,4,1,1,E,2,12,5,7
59C,8/6/21,2,1,1,E,3,8,4,4
59C,8/6/21,1,1,1,E,4,12,4,8
59C,8/6/21,0.5,1,1,E,5,14,3,11
59C,8/6/21,0.25,1,1,E,6,11,7,4
59C,8/6/21,0.125,1,1,E,7,10,3,7
59C,8/6/21,0.0625,1,1,E,8,7,2,5
59C,8/6/21,0.03125,1,1,E,9,10,8,2
59C,8/6/21,0.015625,1,1,E,10,6,3,3
VC,8/6/21,0,1,1,E,12,14,4,10
35H,8/11/21,1.28,1,1,A,1,20,17,3
35H,8/11/21,0.64,1,1,A,2,11,8,3
35H,8/11/21,0.32,1,1,A,3,13,11,2
35H,8/11/21,0.16,1,1,A,4,9,4,5
35H,8/11/21,0.08,1,1,A,5,17,7,10
35H,8/11/21,0.04,1,1,A,6,11,4,7
35H,8/11/21,0.02,1,1,A,7,11,7,4
35H,8/11/21,0.01,1,1,A,8,2,7,2
35H,8/11/21,0.005,1,1,A,9,9,5,9
35H,8/11/21,0.0025,1,1,A,10,9,6,9
VC,8/11/21,0,1,1,A,12,3,4,3
38M,8/11/21,128,1,1,B,1,20,20,0
38M,8/11/21,64,1,1,B,2,14,14,0
38M,8/11/21,32,1,1,B,3,13,13,0
38M,8/11/21,16,1,1,B,4,14,14,0
38M,8/11/21,8,1,1,B,5,9,9,0
38M,8/11/21,4,1,1,B,6,12,12,0
38M,8/11/21,2,1,1,B,7,8,8,0
38M,8/11/21,1,1,1,B,8,15,15,0
38M,8/11/21,0.5,1,1,B,9,9,9,0
38M,8/11/21,0.25,1,1,B,10,9,9,0
VC,8/11/21,0,1,1,B,12,12,2,10
93A,8/11/21,16,1,1,C,1,15,14,1
93A,8/11/21,8,1,1,C,2,16,16,0
93A,8/11/21,4,1,1,C,3,8,8,0
93A,8/11/21,2,1,1,C,4,10,9,1
93A,8/11/21,1,1,1,C,5,15,10,5
93A,8/11/21,0.5,1,1,C,6,16,14,2
93A,8/11/21,0.25,1,1,C,7,7,6,1
93A,8/11/21,0.125,1,1,C,8,16,11,5
93A,8/11/21,0.0625,1,1,C,9,16,6,10
93A,8/11/21,0.03125,1,1,C,10,7,2,5
VC,8/11/21,0,1,1,C,12,9,2,7
93B,8/11/21,139,1,1,D,1,12,8,4
93B,8/11/21,69.5,1,1,D,2,10,4,6
93B,8/11/21,34.75,1,1,D,3,9,4,5
93B,8/11/21,17.375,1,1,D,4,12,10,2
93B,8/11/21,8.6875,1,1,D,5,13,6,7
93B,8/11/21,4.34375,1,1,D,6,8,5,3
93B,8/11/21,2.171875,1,1,D,7,7,2,5
93B,8/11/21,1.0859375,1,1,D,8,7,2,5
93B,8/11/21,0.54296875,1,1,D,9,8,3,5
93B,8/11/21,0.271484375,1,1,D,10,10,5,5
VC,8/11/21,0,1,1,D,12,10,5,5
38A,8/11/21,16,1,1,E,1,14,14,0
38A,8/11/21,8,1,1,E,2,14,14,0
38A,8/11/21,4,1,1,E,3,7,6,1
38A,8/11/21,2,1,1,E,4,12,12,0
38A,8/11/21,1,1,1,E,5,17,13,4
38A,8/11/21,0.5,1,1,E,6,10,9,1
38A,8/11/21,0.25,1,1,E,7,10,8,2
38A,8/11/21,0.125,1,1,E,8,6,5,1
38A,8/11/21,0.0625,1,1,E,9,11,2,9
38A,8/11/21,0.03125,1,1,E,10,9,0,9
VC,8/11/21,0,1,1,E,12,2,1,1
38F,8/11/21,8,1,1,F,1,10,7,3
38F,8/11/21,4,1,1,F,2,13,12,1
38F,8/11/21,2,1,1,F,3,6,6,0
38F,8/11/21,1,1,1,F,4,6,1,5
38F,8/11/21,0.5,1,1,F,5,11,5,6
38F,8/11/21,0.25,1,1,F,6,12,5,7
38F,8/11/21,0.125,1,1,F,7,9,5,4
38F,8/11/21,0.0625,1,1,F,8,14,1,13
38F,8/11/21,0.03125,1,1,F,9,10,5,5
38F,8/11/21,0.015625,1,1,F,10,10,3,7
VC,8/11/21,0,1,1,F,12,16,8,8
57E,8/11/21,32,1,1,G,1,13,13,0
57E,8/11/21,16,1,1,G,2,10,9,1
57E,8/11/21,8,1,1,G,3,11,11,0
57E,8/11/21,4,1,1,G,4,8,8,0
57E,8/11/21,2,1,1,G,5,8,7,1
57E,8/11/21,1,1,1,G,6,12,12,0
57E,8/11/21,0.5,1,1,G,7,6,6,0
57E,8/11/21,0.25,1,1,G,8,10,8,2
57E,8/11/21,0.125,1,1,G,9,21,10,11
57E,8/11/21,0.0625,1,1,G,10,8,5,3
VC,8/11/21,0,1,1,G,12,15,6,9
94A,8/11/21,124.5,1,1,H,1,20,10,10
94A,8/11/21,62.25,1,1,H,2,13,7,6
94A,8/11/21,31.125,1,1,H,3,7,3,4
94A,8/11/21,15.5625,1,1,H,4,16,6,10
94A,8/11/21,7.78125,1,1,H,5,9,5,4
94A,8/11/21,3.890625,1,1,H,6,10,7,3
94A,8/11/21,1.9453125,1,1,H,7,9,5,4
94A,8/11/21,0.97265625,1,1,H,8,12,9,3
94A,8/11/21,0.486328125,1,1,H,9,8,5,3
94A,8/11/21,0.243164063,1,1,H,10,11,3,8
VC,8/11/21,0,1,1,H,12,5,3,2
UTC,8/11/21,0,1,1,A,1,14,9,5
UTC,8/11/21,0,1,1,A,2,13,7,6
UTC,8/11/21,0,1,1,A,3,13,8,5
UTC,8/11/21,0,1,1,A,4,18,10,8
UTC,8/11/21,0,1,1,A,5,8,5,3
UTC,8/11/21,0,1,1,A,6,13,5,8
UTC,8/11/21,0,1,1,A,7,17,9,8
UTC,8/11/21,0,1,1,A,8,10,3,10
UTC,8/11/21,0,1,1,A,9,3,6,3
UTC,8/11/21,0,1,1,A,10,9,8,9
UTC,8/11/21,0,1,1,A,12,3,4,3
UTC,8/11/21,0,1,1,B,1,7,5,2
UTC,8/11/21,0,1,1,B,2,18,11,7
UTC,8/11/21,0,1,1,B,3,11,8,3
UTC,8/11/21,0,1,1,B,4,17,12,5
UTC,8/11/21,0,1,1,B,5,8,2,6
UTC,8/11/21,0,1,1,B,6,15,9,6
UTC,8/11/21,0,1,1,B,7,14,8,6
UTC,8/11/21,0,1,1,B,8,10,9,1
UTC,8/11/21,0,1,1,B,9,14,9,5
UTC,8/11/21,0,1,1,B,10,10,6,4
UTC,8/11/21,0,1,1,B,12,6,2,4
UTC,8/11/21,0,1,1,C,1,15,6,9
UTC,8/11/21,0,1,1,C,2,9,4,5
UTC,8/11/21,0,1,1,C,3,9,4,5
UTC,8/11/21,0,1,1,C,4,13,11,2
UTC,8/11/21,0,1,1,C,5,8,4,4
UTC,8/11/21,0,1,1,C,6,17,12,5
UTC,8/11/21,0,1,1,C,7,6,3,3
UTC,8/11/21,0,1,1,C,8,14,5,9
UTC,8/11/21,0,1,1,C,9,11,5,6
UTC,8/11/21,0,1,1,C,10,4,3,1
UTC,8/11/21,0,1,1,C,12,10,7,3
UTC,8/11/21,0,1,1,D,1,11,6,5
UTC,8/11/21,0,1,1,D,2,17,11,6
UTC,8/11/21,0,1,1,D,3,12,11,1
UTC,8/11/21,0,1,1,D,4,8,3,5
UTC,8/11/21,0,1,1,D,5,10,3,7
UTC,8/11/21,0,1,1,D,6,17,5,12
UTC,8/11/21,0,1,1,D,7,8,4,4
UTC,8/11/21,0,1,1,D,8,15,11,4
UTC,8/11/21,0,1,1,D,9,5,3,2
UTC,8/11/21,0,1,1,D,10,14,4,10
UTC,8/11/21,0,1,1,D,12,12,9,3
UTC,8/11/21,0,1,1,E,1,11,5,6
UTC,8/11/21,0,1,1,E,2,12,9,3
UTC,8/11/21,0,1,1,E,3,10,9,1
UTC,8/11/21,0,1,1,E,4,11,6,5
UTC,8/11/21,0,1,1,E,5,10,6,4
UTC,8/11/21,0,1,1,E,6,12,8,4
UTC,8/11/21,0,1,1,E,7,9,3,6
UTC,8/11/21,0,1,1,E,8,10,4,6
UTC,8/11/21,0,1,1,E,9,9,5,4
UTC,8/11/21,0,1,1,E,10,17,12,5
UTC,8/11/21,0,1,1,E,12,7,3,4
UTC,8/11/21,0,1,1,F,1,9,6,3
UTC,8/11/21,0,1,1,F,2,14,10,4
UTC,8/11/21,0,1,1,F,3,9,4,5
UTC,8/11/21,0,1,1,F,4,15,3,12
UTC,8/11/21,0,1,1,F,5,12,3,9
UTC,8/11/21,0,1,1,F,6,14,4,10
UTC,8/11/21,0,1,1,F,7,13,8,5
UTC,8/11/21,0,1,1,F,8,12,6,6
UTC,8/11/21,0,1,1,F,9,15,12,3
UTC,8/11/21,0,1,1,F,10,19,8,11
UTC,8/11/21,0,1,1,F,12,10,6,4
UTC,8/11/21,0,1,1,G,1,6,4,2
UTC,8/11/21,0,1,1,G,2,14,7,7
UTC,8/11/21,0,1,1,G,3,13,9,4
UTC,8/11/21,0,1,1,G,4,11,8,3
UTC,8/11/21,0,1,1,G,5,15,6,9
UTC,8/11/21,0,1,1,G,6,16,8,8
UTC,8/11/21,0,1,1,G,7,14,7,7
UTC,8/11/21,0,1,1,G,8,10,4,6
UTC,8/11/21,0,1,1,G,9,11,4,7
UTC,8/11/21,0,1,1,G,10,5,2,3
UTC,8/11/21,0,1,1,G,12,12,5,7
UTC,8/11/21,0,1,1,H,1,9,7,2
UTC,8/11/21,0,1,1,H,2,24,17,7
UTC,8/11/21,0,1,1,H,3,21,17,4
UTC,8/11/21,0,1,1,H,4,11,5,6
UTC,8/11/21,0,1,1,H,5,21,10,11
UTC,8/11/21,0,1,1,H,6,21,14,7
UTC,8/11/21,0,1,1,H,7,11,10,1
UTC,8/11/21,0,1,1,H,8,12,9,3
UTC,8/11/21,0,1,1,H,9,13,7,6
UTC,8/11/21,0,1,1,H,10,17,8,9
UTC,8/11/21,0,1,1,H,12,9,7,2
35H,8/12/21,1.28,1,1,A,1,12,10,2
35H,8/12/21,0.64,1,1,A,2,18,13,5
35H,8/12/21,0.32,1,1,A,3,16,11,5
35H,8/12/21,0.16,1,1,A,4,9,6,3
35H,8/12/21,0.08,1,1,A,5,8,3,5
35H,8/12/21,0.04,1,1,A,6,13,7,6
35H,8/12/21,0.02,1,1,A,7,8,3,5
35H,8/12/21,0.01,1,1,A,8,5,7,5
35H,8/12/21,0.005,1,1,A,9,5,2,5
35H,8/12/21,0.0025,1,1,A,10,7,4,7
VC,8/12/21,0,1,1,A,12,4,5,4
38M,8/12/21,128,1,1,B,1,12,12,0
38M,8/12/21,64,1,1,B,2,9,9,0
38M,8/12/21,32,1,1,B,3,24,24,0
38M,8/12/21,16,1,1,B,4,13,13,0
38M,8/12/21,8,1,1,B,5,7,7,0
38M,8/12/21,4,1,1,B,6,14,14,0
38M,8/12/21,2,1,1,B,7,13,13,0
38M,8/12/21,1,1,1,B,8,8,8,0
38M,8/12/21,0.5,1,1,B,9,15,15,0
38M,8/12/21,0.25,1,1,B,10,15,15,0
VC,8/12/21,0,1,1,B,12,10,1,9
93A,8/12/21,16,1,1,C,1,12,11,1
93A,8/12/21,8,1,1,C,2,19,18,1
93A,8/12/21,4,1,1,C,3,14,14,0
93A,8/12/21,2,1,1,C,4,19,17,2
93A,8/12/21,1,1,1,C,5,16,8,8
93A,8/12/21,0.5,1,1,C,6,18,9,9
93A,8/12/21,0.25,1,1,C,7,14,7,7
93A,8/12/21,0.125,1,1,C,8,22,6,16
93A,8/12/21,0.0625,1,1,C,9,18,8,10
93A,8/12/21,0.03125,1,1,C,10,15,6,9
VC,8/12/21,0,1,1,C,12,19,6,13
93B,8/12/21,139,1,1,D,1,8,4,4
93B,8/12/21,69.5,1,1,D,2,12,6,6
93B,8/12/21,34.75,1,1,D,3,13,8,5
93B,8/12/21,17.375,1,1,D,4,14,9,5
93B,8/12/21,8.6875,1,1,D,5,7,2,5
93B,8/12/21,4.34375,1,1,D,6,17,6,11
93B,8/12/21,2.171875,1,1,D,7,13,3,10
93B,8/12/21,1.0859375,1,1,D,8,15,5,10
93B,8/12/21,0.54296875,1,1,D,9,12,9,3
93B,8/12/21,0.271484375,1,1,D,10,10,4,6
VC,8/12/21,0,1,1,D,12,16,3,13
38A,8/12/21,16,1,1,E,1,8,8,0
38A,8/12/21,8,1,1,E,2,17,17,0
38A,8/12/21,4,1,1,E,3,16,16,0
38A,8/12/21,2,1,1,E,4,7,5,2
38A,8/12/21,1,1,1,E,5,11,5,6
38A,8/12/21,0.5,1,1,E,6,12,8,4
38A,8/12/21,0.25,1,1,E,7,19,12,7
38A,8/12/21,0.125,1,1,E,8,10,7,3
38A,8/12/21,0.0625,1,1,E,9,12,2,10
38A,8/12/21,0.03125,1,1,E,10,17,9,8
VC,8/12/21,0,1,1,E,12,13,7,6
38F,8/12/21,8,1,1,F,1,16,9,7
38F,8/12/21,4,1,1,F,2,14,6,8
38F,8/12/21,2,1,1,F,3,10,5,5
38F,8/12/21,1,1,1,F,4,24,10,14
38F,8/12/21,0.5,1,1,F,5,19,9,10
38F,8/12/21,0.25,1,1,F,6,11,7,4
38F,8/12/21,0.125,1,1,F,7,15,7,8
38F,8/12/21,0.0625,1,1,F,8,10,7,3
38F,8/12/21,0.03125,1,1,F,9,16,9,7
38F,8/12/21,0.015625,1,1,F,10,17,4,13
VC,8/12/21,0,1,1,F,12,13,9,4
57E,8/12/21,32,1,1,G,1,15,15,0
57E,8/12/21,16,1,1,G,2,18,18,0
57E,8/12/21,8,1,1,G,3,16,16,0
57E,8/12/21,4,1,1,G,4,14,14,0
57E,8/12/21,2,1,1,G,5,14,14,0
57E,8/12/21,1,1,1,G,6,18,18,0
57E,8/12/21,0.5,1,1,G,7,16,16,0
57E,8/12/21,0.25,1,1,G,8,13,5,8
57E,8/12/21,0.125,1,1,G,9,15,7,8
57E,8/12/21,0.0625,1,1,G,10,13,3,10
VC,8/12/21,0,1,1,G,12,16,3,13
94A,8/12/21,124.5,1,1,H,1,9,8,1
94A,8/12/21,62.25,1,1,H,2,10,4,6
94A,8/12/21,31.125,1,1,H,3,14,5,9
94A,8/12/21,15.5625,1,1,H,4,8,2,6
94A,8/12/21,7.78125,1,1,H,5,8,1,7
94A,8/12/21,3.890625,1,1,H,6,13,6,7
94A,8/12/21,1.9453125,1,1,H,7,5,2,3
94A,8/12/21,0.97265625,1,1,H,8,13,10,3
94A,8/12/21,0.486328125,1,1,H,9,13,6,7
94A,8/12/21,0.243164063,1,1,H,10,9,7,2
VC,8/12/21,0,1,1,H,12,13,7,6
ethanol,8/13/21,20000,1,1,A,1,12,7,5
ethanol,8/13/21,10000,1,1,A,2,10,3,7
ethanol,8/13/21,5000,1,1,A,3,6,3,3
ethanol,8/13/21,2500,1,1,A,4,7,3,4
ethanol,8/13/21,1250,1,1,A,5,10,3,7
ethanol,8/13/21,625,1,1,A,6,15,8,7
ethanol,8/13/21,312.5,1,1,A,7,4,1,3
ethanol,8/13/21,156.25,1,1,A,8,8,4,8
ethanol,8/13/21,78.125,1,1,A,9,7,2,7
ethanol,8/13/21,39.0625,1,1,A,10,2,7,2
VC,8/13/21,0,1,1,A,12,8,6,8
ethanol,8/13/21,20000,1,1,B,1,10,5,5
ethanol,8/13/21,10000,1,1,B,2,12,6,6
ethanol,8/13/21,5000,1,1,B,3,7,5,2
ethanol,8/13/21,2500,1,1,B,4,11,7,4
ethanol,8/13/21,1250,1,1,B,5,12,5,7
ethanol,8/13/21,625,1,1,B,6,11,5,6
ethanol,8/13/21,312.5,1,1,B,7,10,7,3
ethanol,8/13/21,156.25,1,1,B,8,14,10,4
ethanol,8/13/21,78.125,1,1,B,9,12,5,7
ethanol,8/13/21,39.0625,1,1,B,10,18,9,9
VC,8/13/21,0,1,1,B,12,9,7,2
ethanol,8/13/21,20000,1,1,C,1,10,7,3
ethanol,8/13/21,10000,1,1,C,2,12,9,3
ethanol,8/13/21,5000,1,1,C,3,8,3,5
ethanol,8/13/21,2500,1,1,C,4,8,4,4
ethanol,8/13/21,1250,1,1,C,5,8,4,4
ethanol,8/13/21,625,1,1,C,6,4,3,1
ethanol,8/13/21,312.5,1,1,C,7,17,11,6
ethanol,8/13/21,156.25,1,1,C,8,8,2,6
ethanol,8/13/21,78.125,1,1,C,9,14,4,10
ethanol,8/13/21,39.0625,1,1,C,10,12,9,3
VC,8/13/21,0,1,1,C,12,12,7,5
ethanol,8/13/21,20000,1,1,D,1,12,8,4
ethanol,8/13/21,10000,1,1,D,2,8,6,2
ethanol,8/13/21,5000,1,1,D,3,12,8,4
ethanol,8/13/21,2500,1,1,D,4,11,9,2
ethanol,8/13/21,1250,1,1,D,5,16,6,10
ethanol,8/13/21,625,1,1,D,6,12,8,4
ethanol,8/13/21,312.5,1,1,D,7,8,4,4
ethanol,8/13/21,156.25,1,1,D,8,7,4,3
ethanol,8/13/21,78.125,1,1,D,9,15,8,7
ethanol,8/13/21,39.0625,1,1,D,10,12,4,8
VC,8/13/21,0,1,1,D,12,12,4,8
DMSO,8/13/21,30000,1,1,E,1,17,10,7
DMSO,8/13/21,15000,1,1,E,2,11,4,7
DMSO,8/13/21,7500,1,1,E,3,9,1,8
DMSO,8/13/21,3750,1,1,E,4,7,4,3
DMSO,8/13/21,1875,1,1,E,5,10,8,2
DMSO,8/13/21,937.5,1,1,E,6,11,4,7
DMSO,8/13/21,468.75,1,1,E,7,10,4,6
DMSO,8/13/21,234.375,1,1,E,8,13,6,7
DMSO,8/13/21,117.1875,1,1,E,9,6,3,3
DMSO,8/13/21,58.59375,1,1,E,10,13,8,5
VC,8/13/21,0,1,1,E,12,13,8,5
DMSO,8/13/21,30000,1,1,F,1,10,5,5
DMSO,8/13/21,15000,1,1,F,2,14,4,10
DMSO,8/13/21,7500,1,1,F,3,19,3,16
DMSO,8/13/21,3750,1,1,F,4,15,9,6
DMSO,8/13/21,1875,1,1,F,5,9,2,7
DMSO,8/13/21,937.5,1,1,F,6,16,6,10
DMSO,8/13/21,468.75,1,1,F,7,7,3,4
DMSO,8/13/21,234.375,1,1,F,8,11,1,10
DMSO,8/13/21,117.1875,1,1,F,9,13,4,9
DMSO,8/13/21,58.59375,1,1,F,10,17,8,9
VC,8/13/21,0,1,1,F,12,21,9,12
DMSO,8/13/21,20000,1,1,G,1,14,9,5
DMSO,8/13/21,10000,1,1,G,2,9,6,3
DMSO,8/13/21,5000,1,1,G,3,7,3,4
DMSO,8/13/21,2500,1,1,G,4,10,3,7
DMSO,8/13/21,1250,1,1,G,5,13,4,9
DMSO,8/13/21,625,1,1,G,6,10,1,9
DMSO,8/13/21,312.5,1,1,G,7,6,3,3
DMSO,8/13/21,156.25,1,1,G,8,5,3,2
DMSO,8/13/21,78.125,1,1,G,9,11,6,5
DMSO,8/13/21,39.0625,1,1,G,10,8,5,3
VC,8/13/21,0,1,1,G,12,22,16,6
DMSO,8/13/21,20000,1,1,H,1,15,11,4
DMSO,8/13/21,10000,1,1,H,2,8,5,3
DMSO,8/13/21,5000,1,1,H,3,9,6,3
DMSO,8/13/21,2500,1,1,H,4,10,6,4
DMSO,8/13/21,1250,1,1,H,5,10,5,5
DMSO,8/13/21,625,1,1,H,6,6,3,3
DMSO,8/13/21,312.5,1,1,H,7,12,5,7
DMSO,8/13/21,156.25,1,1,H,8,6,2,4
DMSO,8/13/21,78.125,1,1,H,9,6,3,3
DMSO,8/13/21,39.0625,1,1,H,10,10,4,6
VC,8/13/21,0,1,1,H,12,5,3,2
ethanol,8/18/21,50000,1,1,A,1,22,12,10
ethanol,8/18/21,25000,1,1,A,2,17,8,9
ethanol,8/18/21,12500,1,1,A,3,16,11,5
ethanol,8/18/21,6250,1,1,A,4,12,7,5
ethanol,8/18/21,3125,1,1,A,5,15,9,6
ethanol,8/18/21,1562.5,1,1,A,6,10,5,5
ethanol,8/18/21,781.25,1,1,A,7,11,5,6
ethanol,8/18/21,390.625,1,1,A,8,11,7,11
ethanol,8/18/21,195.3125,1,1,A,9,7,9,7
ethanol,8/18/21,97.65625,1,1,A,10,9,9,9
VC,8/18/21,0,1,1,A,12,8,5,8
ethanol,8/18/21,50000,1,1,B,1,16,4,12
ethanol,8/18/21,25000,1,1,B,2,17,6,11
ethanol,8/18/21,12500,1,1,B,3,17,11,6
ethanol,8/18/21,6250,1,1,B,4,9,3,6
ethanol,8/18/21,3125,1,1,B,5,12,6,6
ethanol,8/18/21,1562.5,1,1,B,6,12,5,7
ethanol,8/18/21,781.25,1,1,B,7,15,7,8
ethanol,8/18/21,390.625,1,1,B,8,13,9,4
ethanol,8/18/21,195.3125,1,1,B,9,11,6,5
ethanol,8/18/21,97.65625,1,1,B,10,18,11,7
VC,8/18/21,0,1,1,B,12,16,6,10
DMSO,8/18/21,50000,1,1,C,1,11,7,4
DMSO,8/18/21,25000,1,1,C,2,12,8,4
DMSO,8/18/21,12500,1,1,C,3,19,9,10
DMSO,8/18/21,6250,1,1,C,4,16,6,10
DMSO,8/18/21,3125,1,1,C,5,16,10,6
DMSO,8/18/21,1562.5,1,1,C,6,12,6,6
DMSO,8/18/21,781.25,1,1,C,7,11,6,5
DMSO,8/18/21,390.625,1,1,C,8,10,6,4
DMSO,8/18/21,195.3125,1,1,C,9,13,8,5
DMSO,8/18/21,97.65625,1,1,C,10,13,7,6
VC,8/18/21,0,1,1,C,12,12,9,3
DMSO,8/18/21,50000,1,1,D,1,18,11,7
DMSO,8/18/21,25000,1,1,D,2,11,8,3
DMSO,8/18/21,12500,1,1,D,3,14,10,4
DMSO,8/18/21,6250,1,1,D,4,16,11,5
DMSO,8/18/21,3125,1,1,D,5,9,6,3
DMSO,8/18/21,1562.5,1,1,D,6,10,3,7
DMSO,8/18/21,781.25,1,1,D,7,17,9,8
DMSO,8/18/21,390.625,1,1,D,8,9,8,1
DMSO,8/18/21,195.3125,1,1,D,9,22,11,11
DMSO,8/18/21,97.65625,1,1,D,10,8,4,4
VC,8/18/21,0,1,1,D,12,10,4,6
DMSO,8/18/21,40000,1,1,E,1,12,9,3
DMSO,8/18/21,20000,1,1,E,2,10,6,4
DMSO,8/18/21,10000,1,1,E,3,12,7,5
DMSO,8/18/21,5000,1,1,E,4,10,4,6
DMSO,8/18/21,2500,1,1,E,5,12,7,5
DMSO,8/18/21,1250,1,1,E,6,13,8,5
DMSO,8/18/21,625,1,1,E,7,8,3,5
DMSO,8/18/21,312.5,1,1,E,8,13,6,7
DMSO,8/18/21,156.25,1,1,E,9,16,6,10
DMSO,8/18/21,78.125,1,1,E,10,6,2,4
VC,8/18/21,0,1,1,E,12,11,5,6
DMSO,8/18/21,40000,1,1,F,1,15,9,6
DMSO,8/18/21,20000,1,1,F,2,11,3,8
DMSO,8/18/21,10000,1,1,F,3,18,5,13
DMSO,8/18/21,5000,1,1,F,4,10,1,9
DMSO,8/18/21,2500,1,1,F,5,12,5,7
DMSO,8/18/21,1250,1,1,F,6,14,6,8
DMSO,8/18/21,625,1,1,F,7,19,5,14
DMSO,8/18/21,312.5,1,1,F,8,14,7,7
DMSO,8/18/21,156.25,1,1,F,9,16,7,9
DMSO,8/18/21,78.125,1,1,F,10,14,7,7
VC,8/18/21,0,1,1,F,12,13,7,6
DMSO,8/18/21,40000,1,1,G,1,11,7,4
DMSO,8/18/21,20000,1,1,G,2,8,6,2
DMSO,8/18/21,10000,1,1,G,3,14,8,6
DMSO,8/18/21,5000,1,1,G,4,14,4,10
DMSO,8/18/21,2500,1,1,G,5,15,8,7
DMSO,8/18/21,1250,1,1,G,6,23,9,14
DMSO,8/18/21,625,1,1,G,7,9,5,4
DMSO,8/18/21,312.5,1,1,G,8,12,7,5
DMSO,8/18/21,156.25,1,1,G,9,15,6,9
DMSO,8/18/21,78.125,1,1,G,10,16,5,11
VC,8/18/21,0,1,1,G,12,11,1,10
1036-14B,8/18/21,1.28,1,1,H,1,9,9,0
1036-14B,8/18/21,0.64,1,1,H,2,13,12,1
1036-14B,8/18/21,0.32,1,1,H,3,15,11,4
1036-14B,8/18/21,0.16,1,1,H,4,12,7,5
1036-14B,8/18/21,0.08,1,1,H,5,16,8,8
1036-14B,8/18/21,0.04,1,1,H,6,13,4,9
1036-14B,8/18/21,0.02,1,1,H,7,7,5,2
1036-14B,8/18/21,0.01,1,1,H,8,10,4,6
1036-14B,8/18/21,0.005,1,1,H,9,15,10,5
1036-14B,8/18/21,0.0025,1,1,H,10,20,10,10
VC,8/18/21,0,1,1,H,12,15,6,9
38F,8/19/21,8,1,1,A,1,10,9,1
38F,8/19/21,4,1,1,A,2,16,12,4
38F,8/19/21,2,1,1,A,3,14,11,3
38F,8/19/21,1,1,1,A,4,7,3,4
38F,8/19/21,0.5,1,1,A,5,17,7,10
38F,8/19/21,0.25,1,1,A,6,9,4,5
38F,8/19/21,0.125,1,1,A,7,16,12,4
38F,8/19/21,0.0625,1,1,A,8,8,4,4
38F,8/19/21,0.03125,1,1,A,9,16,9,7
38F,8/19/21,0.015625,1,1,A,10,12,7,5
VC,8/19/21,0,1,1,A,12,5,3,2
93A,8/19/21,16,1,1,B,1,9,9,0
93A,8/19/21,8,1,1,B,2,7,7,0
93A,8/19/21,4,1,1,B,3,18,17,1
93A,8/19/21,2,1,1,B,4,14,14,0
93A,8/19/21,1,1,1,B,5,18,13,5
93A,8/19/21,0.5,1,1,B,6,11,7,4
93A,8/19/21,0.25,1,1,B,7,11,7,4
93A,8/19/21,0.125,1,1,B,8,7,3,4
93A,8/19/21,0.0625,1,1,B,9,20,17,3
93A,8/19/21,0.03125,1,1,B,10,11,5,6
VC,8/19/21,0,1,1,B,12,11,5,6
59C,8/19/21,8,1,1,C,1,11,6,5
59C,8/19/21,4,1,1,C,2,11,9,2
59C,8/19/21,2,1,1,C,3,18,10,8
59C,8/19/21,1,1,1,C,4,8,1,7
59C,8/19/21,0.5,1,1,C,5,13,7,6
59C,8/19/21,0.25,1,1,C,6,13,8,5
59C,8/19/21,0.125,1,1,C,7,13,4,9
59C,8/19/21,0.0625,1,1,C,8,11,8,3
59C,8/19/21,0.03125,1,1,C,9,12,3,9
59C,8/19/21,0.015625,1,1,C,10,13,7,6
VC,8/19/21,0,1,1,C,12,8,3,5
59E,8/19/21,8,1,1,D,1,21,16,5
59E,8/19/21,4,1,1,D,2,14,10,4
59E,8/19/21,2,1,1,D,3,18,16,2
59E,8/19/21,1,1,1,D,4,19,19,0
59E,8/19/21,0.5,1,1,D,5,8,7,1
59E,8/19/21,0.25,1,1,D,6,8,7,1
59E,8/19/21,0.125,1,1,D,7,8,2,6
59E,8/19/21,0.0625,1,1,D,8,14,6,8
59E,8/19/21,0.03125,1,1,D,9,17,4,13
59E,8/19/21,0.015625,1,1,D,10,12,6,6
VC,8/19/21,0,1,1,D,12,10,8,2
59B,8/19/21,8,1,1,E,1,12,12,0
59B,8/19/21,4,1,1,E,2,9,9,0
59B,8/19/21,2,1,1,E,3,7,5,2
59B,8/19/21,1,1,1,E,4,8,7,1
59B,8/19/21,0.5,1,1,E,5,10,2,8
59B,8/19/21,0.25,1,1,E,6,11,3,8
59B,8/19/21,0.125,1,1,E,7,11,7,4
59B,8/19/21,0.0625,1,1,E,8,16,8,8
59B,8/19/21,0.03125,1,1,E,9,7,1,6
59B,8/19/21,0.015625,1,1,E,10,18,12,6
VC,8/19/21,0,1,1,E,12,13,5,8
40C,8/19/21,128,1,1,F,1,12,4,8
40C,8/19/21,64,1,1,F,2,15,7,8
40C,8/19/21,32,1,1,F,3,21,9,12
40C,8/19/21,16,1,1,F,4,10,6,4
40C,8/19/21,8,1,1,F,5,10,8,2
40C,8/19/21,4,1,1,F,6,9,3,6
40C,8/19/21,2,1,1,F,7,14,7,7
40C,8/19/21,1,1,1,F,8,13,8,5
40C,8/19/21,0.5,1,1,F,9,8,3,5
40C,8/19/21,0.25,1,1,F,10,10,2,8
VC,8/19/21,0,1,1,F,12,7,1,6
59G,8/19/21,16,1,1,G,1,9,3,6
59G,8/19/21,8,1,1,G,2,21,10,11
59G,8/19/21,4,1,1,G,3,19,9,10
59G,8/19/21,2,1,1,G,4,12,5,7
59G,8/19/21,1,1,1,G,5,15,10,5
59G,8/19/21,0.5,1,1,G,6,11,6,5
59G,8/19/21,0.25,1,1,G,7,14,5,9
59G,8/19/21,0.125,1,1,G,8,15,6,9
59G,8/19/21,0.0625,1,1,G,9,12,5,7
59G,8/19/21,0.03125,1,1,G,10,10,3,7
VC,8/19/21,0,1,1,G,12,15,5,10
1036-14B,8/19/21,1.28,1,1,H,1,14,14,0
1036-14B,8/19/21,0.64,1,1,H,2,7,7,0
1036-14B,8/19/21,0.32,1,1,H,3,8,3,5
1036-14B,8/19/21,0.16,1,1,H,4,20,10,10
1036-14B,8/19/21,0.08,1,1,H,5,10,3,7
1036-14B,8/19/21,0.04,1,1,H,6,9,6,3
1036-14B,8/19/21,0.02,1,1,H,7,8,3,5
1036-14B,8/19/21,0.01,1,1,H,8,12,3,9
1036-14B,8/19/21,0.005,1,1,H,9,11,6,5
1036-14B,8/19/21,0.0025,1,1,H,10,10,2,8
VC,8/19/21,0,1,1,H,12,6,2,4
38F,8/20/21,8,1,1,A,1,18,13,5
38F,8/20/21,4,1,1,A,2,26,17,9
38F,8/20/21,2,1,1,A,3,14,11,3
38F,8/20/21,1,1,1,A,4,14,6,8
38F,8/20/21,0.5,1,1,A,5,20,13,7
38F,8/20/21,0.25,1,1,A,6,11,6,5
38F,8/20/21,0.125,1,1,A,7,12,7,5
38F,8/20/21,0.0625,1,1,A,8,17,7,10
38F,8/20/21,0.03125,1,1,A,9,12,4,8
38F,8/20/21,0.015625,1,1,A,10,14,7,7
VC,8/20/21,0,1,1,A,12,5,3,2
93A,8/20/21,16,1,1,B,1,18,13,5
93A,8/20/21,8,1,1,B,2,22,22,0
93A,8/20/21,4,1,1,B,3,19,19,0
93A,8/20/21,2,1,1,B,4,12,9,3
93A,8/20/21,1,1,1,B,5,14,8,6
93A,8/20/21,0.5,1,1,B,6,12,12,0
93A,8/20/21,0.25,1,1,B,7,10,6,4
93A,8/20/21,0.125,1,1,B,8,11,5,6
93A,8/20/21,0.0625,1,1,B,9,12,10,2
93A,8/20/21,0.03125,1,1,B,10,14,5,9
VC,8/20/21,0,1,1,B,12,10,6,4
59C,8/20/21,8,1,1,C,1,21,11,10
59C,8/20/21,4,1,1,C,2,16,5,11
59C,8/20/21,2,1,1,C,3,16,12,4
59C,8/20/21,1,1,1,C,4,14,8,6
59C,8/20/21,0.5,1,1,C,5,18,9,9
59C,8/20/21,0.25,1,1,C,6,8,2,6
59C,8/20/21,0.125,1,1,C,7,18,6,12
59C,8/20/21,0.0625,1,1,C,8,17,9,8
59C,8/20/21,0.03125,1,1,C,9,18,7,11
59C,8/20/21,0.015625,1,1,C,10,12,3,9
VC,8/20/21,0,1,1,C,12,8,3,5
59E,8/20/21,8,1,1,D,1,25,25,0
59E,8/20/21,4,1,1,D,2,18,15,3
59E,8/20/21,2,1,1,D,3,24,23,1
59E,8/20/21,1,1,1,D,4,11,3,8
59E,8/20/21,0.5,1,1,D,5,10,9,1
59E,8/20/21,0.25,1,1,D,6,9,6,3
59E,8/20/21,0.125,1,1,D,7,9,5,4
59E,8/20/21,0.0625,1,1,D,8,9,8,1
59E,8/20/21,0.03125,1,1,D,9,12,4,8
59E,8/20/21,0.015625,1,1,D,10,15,7,8
VC,8/20/21,0,1,1,D,12,10,5,5
59B,8/20/21,8,1,1,E,1,6,6,0
59B,8/20/21,4,1,1,E,2,6,6,0
59B,8/20/21,2,1,1,E,3,17,16,1
59B,8/20/21,1,1,1,E,4,13,6,7
59B,8/20/21,0.5,1,1,E,5,15,4,11
59B,8/20/21,0.25,1,1,E,6,11,4,7
59B,8/20/21,0.125,1,1,E,7,7,1,6
59B,8/20/21,0.0625,1,1,E,8,17,11,6
59B,8/20/21,0.03125,1,1,E,9,7,3,4
59B,8/20/21,0.015625,1,1,E,10,20,11,9
VC,8/20/21,0,1,1,E,12,9,2,7
40C,8/20/21,128,1,1,F,1,13,11,2
40C,8/20/21,64,1,1,F,2,11,7,4
40C,8/20/21,32,1,1,F,3,15,8,7
40C,8/20/21,16,1,1,F,4,20,11,9
40C,8/20/21,8,1,1,F,5,15,9,6
40C,8/20/21,4,1,1,F,6,11,7,4
40C,8/20/21,2,1,1,F,7,14,8,6
40C,8/20/21,1,1,1,F,8,11,8,3
40C,8/20/21,0.5,1,1,F,9,6,3,3
40C,8/20/21,0.25,1,1,F,10,18,11,7
VC,8/20/21,0,1,1,F,12,5,4,1
59G,8/20/21,16,1,1,G,1,15,10,5
59G,8/20/21,8,1,1,G,2,20,9,11
59G,8/20/21,4,1,1,G,3,21,12,9
59G,8/20/21,2,1,1,G,4,10,8,2
59G,8/20/21,1,1,1,G,5,19,12,7
59G,8/20/21,0.5,1,1,G,6,13,8,5
59G,8/20/21,0.25,1,1,G,7,13,11,2
59G,8/20/21,0.125,1,1,G,8,12,9,3
59G,8/20/21,0.0625,1,1,G,9,10,6,4
59G,8/20/21,0.03125,1,1,G,10,13,12,1
VC,8/20/21,0,1,1,G,12,10,5,5
1036-14B,8/20/21,1.28,1,1,H,1,10,10,0
1036-14B,8/20/21,0.64,1,1,H,2,10,10,0
1036-14B,8/20/21,0.32,1,1,H,3,8,7,1
1036-14B,8/20/21,0.16,1,1,H,4,17,11,6
1036-14B,8/20/21,0.08,1,1,H,5,11,6,5
1036-14B,8/20/21,0.04,1,1,H,6,10,9,1
1036-14B,8/20/21,0.02,1,1,H,7,7,7,0
1036-14B,8/20/21,0.01,1,1,H,8,13,8,5
1036-14B,8/20/21,0.005,1,1,H,9,9,6,3
1036-14B,8/20/21,0.0025,1,1,H,10,14,12,2
VC,8/20/21,0,1,1,H,12,9,7,2
94N,8/25/21,160.5,1,1,A,1,16,8,8
94N,8/25/21,80.25,1,1,A,2,14,5,9
94N,8/25/21,40.125,1,1,A,3,14,8,6
94N,8/25/21,20.0625,1,1,A,4,18,10,8
94N,8/25/21,10.03125,1,1,A,5,11,9,2
94N,8/25/21,5.015625,1,1,A,6,7,2,5
94N,8/25/21,2.5078125,1,1,A,7,19,12,7
94N,8/25/21,1.25390625,1,1,A,8,15,9,6
94N,8/25/21,0.626953125,1,1,A,9,11,10,1
94N,8/25/21,0.313476563,1,1,A,10,7,7,0
VC,8/25/21,0,1,1,A,12,11,2,9
94O,8/25/21,66.25,1,1,B,1,10,7,3
94O,8/25/21,33.125,1,1,B,2,10,3,7
94O,8/25/21,16.5625,1,1,B,3,11,6,5
94O,8/25/21,8.28125,1,1,B,4,11,6,5
94O,8/25/21,4.140625,1,1,B,5,16,7,9
94O,8/25/21,2.0703125,1,1,B,6,15,8,7
94O,8/25/21,1.03515625,1,1,B,7,7,2,5
94O,8/25/21,0.517578125,1,1,B,8,16,5,11
94O,8/25/21,0.258789063,1,1,B,9,13,8,5
94O,8/25/21,0.129394531,1,1,B,10,8,4,4
VC,8/25/21,0,1,1,B,12,6,2,4
94P,8/25/21,128,1,1,C,1,12,7,5
94P,8/25/21,64,1,1,C,2,11,4,7
94P,8/25/21,32,1,1,C,3,15,7,8
94P,8/25/21,16,1,1,C,4,7,4,3
94P,8/25/21,8,1,1,C,5,17,7,10
94P,8/25/21,4,1,1,C,6,12,10,2
94P,8/25/21,2,1,1,C,7,16,9,7
94P,8/25/21,1,1,1,C,8,14,7,7
94P,8/25/21,0.5,1,1,C,9,11,4,7
94P,8/25/21,0.25,1,1,C,10,16,6,10
VC,8/25/21,0,1,1,C,12,10,6,4
94Q,8/25/21,142.5,1,1,D,1,10,8,2
94Q,8/25/21,71.25,1,1,D,2,18,4,14
94Q,8/25/21,35.625,1,1,D,3,11,0,11
94Q,8/25/21,17.8125,1,1,D,4,12,9,3
94Q,8/25/21,8.90625,1,1,D,5,11,4,7
94Q,8/25/21,4.453125,1,1,D,6,13,9,4
94Q,8/25/21,2.2265625,1,1,D,7,14,3,11
94Q,8/25/21,1.11328125,1,1,D,8,12,5,7
94Q,8/25/21,0.556640625,1,1,D,9,12,2,10
94Q,8/25/21,0.278320313,1,1,D,10,11,3,8
VC,8/25/21,0,1,1,D,12,13,8,5
94R,8/25/21,139.5,1,1,E,1,11,3,8
94R,8/25/21,69.75,1,1,E,2,18,9,9
94R,8/25/21,34.875,1,1,E,3,14,5,9
94R,8/25/21,17.4375,1,1,E,4,8,3,5
94R,8/25/21,8.71875,1,1,E,5,16,7,9
94R,8/25/21,4.359375,1,1,E,6,18,9,9
94R,8/25/21,2.1796875,1,1,E,7,14,7,7
94R,8/25/21,1.08984375,1,1,E,8,12,7,5
94R,8/25/21,0.544921875,1,1,E,9,15,7,8
94R,8/25/21,0.272460938,1,1,E,10,7,4,3
VC,8/25/21,0,1,1,E,12,13,9,4
94S,8/25/21,128.5,1,1,F,1,12,5,7
94S,8/25/21,64.25,1,1,F,2,11,2,9
94S,8/25/21,32.125,1,1,F,3,12,6,6
94S,8/25/21,16.0625,1,1,F,4,10,3,7
94S,8/25/21,8.03125,1,1,F,5,13,9,4
94S,8/25/21,4.015625,1,1,F,6,13,6,7
94S,8/25/21,2.0078125,1,1,F,7,11,9,2
94S,8/25/21,1.00390625,1,1,F,8,15,10,5
94S,8/25/21,0.501953125,1,1,F,9,10,4,6
94S,8/25/21,0.250976563,1,1,F,10,9,6,3
VC,8/25/21,0,1,1,F,12,16,13,3
94T,8/25/21,136,1,1,G,1,8,4,4
94T,8/25/21,68,1,1,G,2,7,5,2
94T,8/25/21,34,1,1,G,3,11,7,4
94T,8/25/21,17,1,1,G,4,14,6,8
94T,8/25/21,8.5,1,1,G,5,17,12,5
94T,8/25/21,4.25,1,1,G,6,21,14,7
94T,8/25/21,2.125,1,1,G,7,12,6,6
94T,8/25/21,1.0625,1,1,G,8,8,3,5
94T,8/25/21,0.53125,1,1,G,9,10,5,5
94T,8/25/21,0.265625,1,1,G,10,8,3,5
VC,8/25/21,0,1,1,G,12,12,10,2
94U,8/25/21,139,1,1,H,1,14,7,7
94U,8/25/21,69.5,1,1,H,2,12,10,2
94U,8/25/21,34.75,1,1,H,3,11,7,4
94U,8/25/21,17.375,1,1,H,4,19,5,14
94U,8/25/21,8.6875,1,1,H,5,12,11,1
94U,8/25/21,4.34375,1,1,H,6,14,7,7
94U,8/25/21,2.171875,1,1,H,7,14,6,8
94U,8/25/21,1.0859375,1,1,H,8,16,9,7
94U,8/25/21,0.54296875,1,1,H,9,7,2,5
94U,8/25/21,0.271484375,1,1,H,10,16,6,10
VC,8/25/21,0,1,1,H,12,11,7,4
94N,8/26/21,160.5,1,1,A,1,12,2,10
94N,8/26/21,80.25,1,1,A,2,13,6,7
94N,8/26/21,40.125,1,1,A,3,0,,
94N,8/26/21,20.0625,1,1,A,4,12,8,4
94N,8/26/21,10.03125,1,1,A,5,11,4,7
94N,8/26/21,5.015625,1,1,A,6,15,7,8
94N,8/26/21,2.5078125,1,1,A,7,9,3,6
94N,8/26/21,1.25390625,1,1,A,8,10,4,6
94N,8/26/21,0.626953125,1,1,A,9,9,3,6
94N,8/26/21,0.313476563,1,1,A,10,8,3,5
VC,8/26/21,0,1,1,A,12,10,7,3
94O,8/26/21,66.25,1,1,B,1,14,6,8
94O,8/26/21,33.125,1,1,B,2,7,4,3
94O,8/26/21,16.5625,1,1,B,3,10,4,6
94O,8/26/21,8.28125,1,1,B,4,18,3,15
94O,8/26/21,4.140625,1,1,B,5,14,7,7
94O,8/26/21,2.0703125,1,1,B,6,16,9,7
94O,8/26/21,1.03515625,1,1,B,7,9,7,2
94O,8/26/21,0.517578125,1,1,B,8,15,3,12
94O,8/26/21,0.258789063,1,1,B,9,19,7,12
94O,8/26/21,0.129394531,1,1,B,10,19,6,13
VC,8/26/21,0,1,1,B,12,14,2,12
94P,8/26/21,128,1,1,C,1,9,3,6
94P,8/26/21,64,1,1,C,2,10,6,4
94P,8/26/21,32,1,1,C,3,9,2,7
94P,8/26/21,16,1,1,C,4,14,3,11
94P,8/26/21,8,1,1,C,5,14,7,7
94P,8/26/21,4,1,1,C,6,12,7,5
94P,8/26/21,2,1,1,C,7,14,4,10
94P,8/26/21,1,1,1,C,8,16,6,10
94P,8/26/21,0.5,1,1,C,9,10,3,7
94P,8/26/21,0.25,1,1,C,10,12,3,9
VC,8/26/21,0,1,1,C,12,11,4,7
94Q,8/26/21,142.5,1,1,D,1,11,3,8
94Q,8/26/21,71.25,1,1,D,2,21,6,15
94Q,8/26/21,35.625,1,1,D,3,13,5,8
94Q,8/26/21,17.8125,1,1,D,4,12,2,10
94Q,8/26/21,8.90625,1,1,D,5,12,3,9
94Q,8/26/21,4.453125,1,1,D,6,13,8,5
94Q,8/26/21,2.2265625,1,1,D,7,16,11,5
94Q,8/26/21,1.11328125,1,1,D,8,13,5,8
94Q,8/26/21,0.556640625,1,1,D,9,13,1,12
94Q,8/26/21,0.278320313,1,1,D,10,13,7,6
VC,8/26/21,0,1,1,D,12,11,6,5
94R,8/26/21,139.5,1,1,E,1,21,10,11
94R,8/26/21,69.75,1,1,E,2,11,2,9
94R,8/26/21,34.875,1,1,E,3,8,3,5
94R,8/26/21,17.4375,1,1,E,4,6,2,4
94R,8/26/21,8.71875,1,1,E,5,9,1,8
94R,8/26/21,4.359375,1,1,E,6,10,5,5
94R,8/26/21,2.1796875,1,1,E,7,13,6,7
94R,8/26/21,1.08984375,1,1,E,8,9,3,6
94R,8/26/21,0.544921875,1,1,E,9,12,2,10
94R,8/26/21,0.272460938,1,1,E,10,8,2,6
VC,8/26/21,0,1,1,E,12,5,0,5
94S,8/26/21,128.5,1,1,F,1,12,7,5
94S,8/26/21,64.25,1,1,F,2,18,11,7
94S,8/26/21,32.125,1,1,F,3,11,3,8
94S,8/26/21,16.0625,1,1,F,4,8,3,5
94S,8/26/21,8.03125,1,1,F,5,9,1,8
94S,8/26/21,4.015625,1,1,F,6,12,2,10
94S,8/26/21,2.0078125,1,1,F,7,12,6,6
94S,8/26/21,1.00390625,1,1,F,8,10,2,8
94S,8/26/21,0.501953125,1,1,F,9,9,2,7
94S,8/26/21,0.250976563,1,1,F,10,15,5,10
VC,8/26/21,0,1,1,F,12,13,7,6
94T,8/26/21,136,1,1,G,1,11,3,8
94T,8/26/21,68,1,1,G,2,16,7,9
94T,8/26/21,34,1,1,G,3,10,6,4
94T,8/26/21,17,1,1,G,4,10,5,5
94T,8/26/21,8.5,1,1,G,5,10,1,9
94T,8/26/21,4.25,1,1,G,6,11,6,5
94T,8/26/21,2.125,1,1,G,7,12,7,5
94T,8/26/21,1.0625,1,1,G,8,10,7,3
94T,8/26/21,0.53125,1,1,G,9,11,7,4
94T,8/26/21,0.265625,1,1,G,10,9,5,4
VC,8/26/21,0,1,1,G,12,15,8,7
94U,8/26/21,139,1,1,H,1,14,7,7
94U,8/26/21,69.5,1,1,H,2,13,5,8
94U,8/26/21,34.75,1,1,H,3,11,4,7
94U,8/26/21,17.375,1,1,H,4,11,4,7
94U,8/26/21,8.6875,1,1,H,5,15,15,0
94U,8/26/21,4.34375,1,1,H,6,13,7,6
94U,8/26/21,2.171875,1,1,H,7,15,6,9
94U,8/26/21,1.0859375,1,1,H,8,15,8,7
94U,8/26/21,0.54296875,1,1,H,9,5,1,4
94U,8/26/21,0.271484375,1,1,H,10,9,4,5
VC,8/26/21,0,1,1,H,12,11,5,6
94N,8/27/21,160.5,1,1,A,1,14,8,6
94N,8/27/21,80.25,1,1,A,2,6,5,1
94N,8/27/21,40.125,1,1,A,3,7,3,4
94N,8/27/21,20.0625,1,1,A,4,11,4,7
94N,8/27/21,10.03125,1,1,A,5,19,9,10
94N,8/27/21,5.015625,1,1,A,6,10,3,7
94N,8/27/21,2.5078125,1,1,A,7,12,5,7
94N,8/27/21,1.25390625,1,1,A,8,13,6,7
94N,8/27/21,0.626953125,1,1,A,9,14,9,5
94N,8/27/21,0.313476563,1,1,A,10,11,3,8
VC,8/27/21,0,1,1,A,12,19,9,10
94O,8/27/21,66.25,1,1,B,1,7,4,3
94O,8/27/21,33.125,1,1,B,2,7,4,3
94O,8/27/21,16.5625,1,1,B,3,8,2,6
94O,8/27/21,8.28125,1,1,B,4,10,4,6
94O,8/27/21,4.140625,1,1,B,5,12,4,8
94O,8/27/21,2.0703125,1,1,B,6,12,7,5
94O,8/27/21,1.03515625,1,1,B,7,14,7,7
94O,8/27/21,0.517578125,1,1,B,8,14,9,5
94O,8/27/21,0.258789063,1,1,B,9,8,5,3
94O,8/27/21,0.129394531,1,1,B,10,14,4,10
VC,8/27/21,0,1,1,B,12,7,5,2
94P,8/27/21,128,1,1,C,1,6,5,1
94P,8/27/21,64,1,1,C,2,12,5,7
94P,8/27/21,32,1,1,C,3,8,7,1
94P,8/27/21,16,1,1,C,4,18,8,10
94P,8/27/21,8,1,1,C,5,6,3,3
94P,8/27/21,4,1,1,C,6,15,3,12
94P,8/27/21,2,1,1,C,7,8,3,5
94P,8/27/21,1,1,1,C,8,9,4,5
94P,8/27/21,0.5,1,1,C,9,16,5,11
94P,8/27/21,0.25,1,1,C,10,14,8,6
VC,8/27/21,0,1,1,C,12,15,2,13
94Q,8/27/21,142.5,1,1,D,1,11,3,8
94Q,8/27/21,71.25,1,1,D,2,12,5,7
94Q,8/27/21,35.625,1,1,D,3,11,4,7
94Q,8/27/21,17.8125,1,1,D,4,11,7,4
94Q,8/27/21,8.90625,1,1,D,5,11,6,5
94Q,8/27/21,4.453125,1,1,D,6,85,7,78
94Q,8/27/21,2.2265625,1,1,D,7,12,6,6
94Q,8/27/21,1.11328125,1,1,D,8,17,6,11
94Q,8/27/21,0.556640625,1,1,D,9,14,5,9
94Q,8/27/21,0.278320313,1,1,D,10,14,6,8
VC,8/27/21,0,1,1,D,12,13,7,6
94R,8/27/21,139.5,1,1,E,1,10,4,6
94R,8/27/21,69.75,1,1,E,2,14,7,7
94R,8/27/21,34.875,1,1,E,3,14,9,5
94R,8/27/21,17.4375,1,1,E,4,13,7,6
94R,8/27/21,8.71875,1,1,E,5,20,14,6
94R,8/27/21,4.359375,1,1,E,6,9,7,2
94R,8/27/21,2.1796875,1,1,E,7,9,4,5
94R,8/27/21,1.08984375,1,1,E,8,15,10,5
94R,8/27/21,0.544921875,1,1,E,9,14,7,7
94R,8/27/21,0.272460938,1,1,E,10,11,4,7
VC,8/27/21,0,1,1,E,12,10,6,4
94S,8/27/21,128.5,1,1,F,1,11,7,4
94S,8/27/21,64.25,1,1,F,2,10,7,3
94S,8/27/21,32.125,1,1,F,3,8,6,2
94S,8/27/21,16.0625,1,1,F,4,13,6,7
94S,8/27/21,8.03125,1,1,F,5,9,6,3
94S,8/27/21,4.015625,1,1,F,6,9,4,5
94S,8/27/21,2.0078125,1,1,F,7,18,5,13
94S,8/27/21,1.00390625,1,1,F,8,10,5,5
94S,8/27/21,0.501953125,1,1,F,9,14,8,6
94S,8/27/21,0.250976563,1,1,F,10,6,4,2
VC,8/27/21,0,1,1,F,12,11,5,6
94T,8/27/21,136,1,1,G,1,10,5,5
94T,8/27/21,68,1,1,G,2,12,7,5
94T,8/27/21,34,1,1,G,3,7,2,5
94T,8/27/21,17,1,1,G,4,15,11,4
94T,8/27/21,8.5,1,1,G,5,13,4,9
94T,8/27/21,4.25,1,1,G,6,12,5,7
94T,8/27/21,2.125,1,1,G,7,17,7,10
94T,8/27/21,1.0625,1,1,G,8,14,7,7
94T,8/27/21,0.53125,1,1,G,9,15,5,10
94T,8/27/21,0.265625,1,1,G,10,8,3,5
VC,8/27/21,0,1,1,G,12,16,9,7
94U,8/27/21,139,1,1,H,1,5,5,0
94U,8/27/21,69.5,1,1,H,2,9,6,3
94U,8/27/21,34.75,1,1,H,3,9,9,0
94U,8/27/21,17.375,1,1,H,4,7,3,4
94U,8/27/21,8.6875,1,1,H,5,7,5,2
94U,8/27/21,4.34375,1,1,H,6,12,6,6
94U,8/27/21,2.171875,1,1,H,7,14,9,5
94U,8/27/21,1.0859375,1,1,H,8,14,9,5
94U,8/27/21,0.54296875,1,1,H,9,10,9,1
94U,8/27/21,0.271484375,1,1,H,10,11,6,5
VC,8/27/21,0,1,1,H,12,10,4,6